country,noc,gold,silver,bronze,total,year,season,all_awarded,percent_won
United States,USA,11,7,2,20,1896,Summer,122,0.163934426
Greece,GRE,10,18,19,47,1896,Summer,122,0.385245902
Germany,GER,6,5,2,13,1896,Summer,122,0.106557377
France,FRA,5,4,2,11,1896,Summer,122,0.090163934
Great Britain,GBR,2,3,2,7,1896,Summer,122,0.057377049
Hungary,HUN,2,1,3,6,1896,Summer,122,0.049180328
Austria,AUT,2,1,2,5,1896,Summer,122,0.040983607
Australia,AUS,2,0,0,2,1896,Summer,122,0.016393443
Denmark,DEN,1,2,3,6,1896,Summer,122,0.049180328
Switzerland,SUI,1,2,0,3,1896,Summer,122,0.024590164
Mixed team,MIX,1,0,1,2,1896,Summer,122,0.016393443
France,FRA,31,41,40,112,1900,Summer,284,0.394366197
United States,USA,20,13,15,48,1900,Summer,284,0.169014085
Great Britain,GBR,20,8,9,37,1900,Summer,284,0.13028169
Belgium,BEL,6,6,6,18,1900,Summer,284,0.063380282
Switzerland,SUI,6,3,1,10,1900,Summer,284,0.035211268
Germany,GER,4,3,2,9,1900,Summer,284,0.031690141
Italy,ITA,3,2,0,5,1900,Summer,284,0.017605634
Denmark,DEN,1,3,2,6,1900,Summer,284,0.021126761
Mixed team,MIX,1,2,3,6,1900,Summer,284,0.021126761
Netherlands,NED,1,2,3,6,1900,Summer,284,0.021126761
Hungary,HUN,1,2,2,5,1900,Summer,284,0.017605634
Cuba,CUB,1,1,0,2,1900,Summer,284,0.007042254
Spain,ESP,1,0,0,1,1900,Summer,284,0.003521127
Austria,AUT,0,3,3,6,1900,Summer,284,0.021126761
Norway,NOR,0,2,3,5,1900,Summer,284,0.017605634
India,IND,0,2,0,2,1900,Summer,284,0.007042254
Bohemia,BOH,0,1,1,2,1900,Summer,284,0.007042254
Australia,AUS,0,0,3,3,1900,Summer,284,0.01056338
Sweden,SWE,0,0,1,1,1900,Summer,284,0.003521127
United States,USA,80,85,83,248,1904,Summer,280,0.885714286
Germany,GER,5,4,5,14,1904,Summer,280,0.05
Canada,CAN,4,1,1,6,1904,Summer,280,0.021428571
Cuba,CUB,3,0,0,3,1904,Summer,280,0.010714286
Hungary,HUN,2,1,1,4,1904,Summer,280,0.014285714
Great Britain,GBR,1,1,0,2,1904,Summer,280,0.007142857
Greece,GRE,1,0,1,2,1904,Summer,280,0.007142857
Mixed team,MIX,1,0,0,1,1904,Summer,280,0.003571429
Great Britain,GBR,56,51,39,146,1908,Summer,324,0.450617284
United States,USA,23,12,12,47,1908,Summer,324,0.145061728
Sweden,SWE,8,6,11,25,1908,Summer,324,0.077160494
France,FRA,5,5,9,19,1908,Summer,324,0.058641975
Germany,GER,3,5,5,13,1908,Summer,324,0.040123457
Hungary,HUN,3,4,2,9,1908,Summer,324,0.027777778
Canada,CAN,3,3,10,16,1908,Summer,324,0.049382716
Norway,NOR,2,3,3,8,1908,Summer,324,0.024691358
Italy,ITA,2,2,0,4,1908,Summer,324,0.012345679
Belgium,BEL,1,5,2,8,1908,Summer,324,0.024691358
Australasia,ANZ,1,2,2,5,1908,Summer,324,0.015432099
Russian Federation,RUS,1,2,0,3,1908,Summer,324,0.009259259
Finland,FIN,1,1,3,5,1908,Summer,324,0.015432099
South Africa,RSA,1,1,0,2,1908,Summer,324,0.00617284
Greece,GRE,0,3,1,4,1908,Summer,324,0.012345679
Denmark,DEN,0,2,3,5,1908,Summer,324,0.015432099
Bohemia,BOH,0,0,2,2,1908,Summer,324,0.00617284
Netherlands,NED,0,0,2,2,1908,Summer,324,0.00617284
Austria,AUT,0,0,1,1,1908,Summer,324,0.00308642
United States,USA,26,19,19,64,1912,Summer,317,0.201892744
Sweden,SWE,23,25,17,65,1912,Summer,317,0.205047319
Great Britain,GBR,10,15,16,41,1912,Summer,317,0.129337539
Finland,FIN,9,8,9,26,1912,Summer,317,0.082018927
France,FRA,7,5,3,15,1912,Summer,317,0.047318612
Germany,GER,6,13,7,26,1912,Summer,317,0.082018927
Italy,ITA,5,1,2,8,1912,Summer,317,0.025236593
South Africa,RSA,4,2,0,6,1912,Summer,317,0.018927445
Norway,NOR,3,2,5,10,1912,Summer,317,0.031545741
Canada,CAN,3,2,3,8,1912,Summer,317,0.025236593
Hungary,HUN,3,2,3,8,1912,Summer,317,0.025236593
Australasia,ANZ,2,2,3,7,1912,Summer,317,0.022082019
Belgium,BEL,2,1,3,6,1912,Summer,317,0.018927445
Denmark,DEN,1,6,5,12,1912,Summer,317,0.03785489
Greece,GRE,1,0,1,2,1912,Summer,317,0.006309148
Switzerland,SUI,1,0,0,1,1912,Summer,317,0.003154574
Russian Federation,RUS,0,2,3,5,1912,Summer,317,0.015772871
Austria,AUT,0,2,2,4,1912,Summer,317,0.012618297
Netherlands,NED,0,0,3,3,1912,Summer,317,0.009463722
United States,USA,41,27,27,95,1920,Summer,449,0.211581292
Sweden,SWE,19,20,25,64,1920,Summer,449,0.142538976
Belgium,BEL,16,12,14,42,1920,Summer,449,0.093541203
Finland,FIN,15,10,9,34,1920,Summer,449,0.075723831
Great Britain,GBR,14,16,13,43,1920,Summer,449,0.095768374
Italy,ITA,14,6,5,25,1920,Summer,449,0.055679287
Norway,NOR,13,10,9,32,1920,Summer,449,0.071269488
France,FRA,9,20,13,42,1920,Summer,449,0.093541203
Netherlands,NED,4,2,5,11,1920,Summer,449,0.024498886
Denmark,DEN,3,9,1,13,1920,Summer,449,0.028953229
South Africa,RSA,3,4,3,10,1920,Summer,449,0.022271715
Canada,CAN,3,3,3,9,1920,Summer,449,0.020044543
Switzerland,SUI,2,2,7,11,1920,Summer,449,0.024498886
Estonia,EST,1,2,0,3,1920,Summer,449,0.006681514
Brazil,BRA,1,1,1,3,1920,Summer,449,0.006681514
Australia,AUS,0,2,1,3,1920,Summer,449,0.006681514
Japan,JPN,0,2,0,2,1920,Summer,449,0.004454343
Spain,ESP,0,2,0,2,1920,Summer,449,0.004454343
Greece,GRE,0,1,0,1,1920,Summer,449,0.002227171
Luxembourg,LUX,0,1,0,1,1920,Summer,449,0.002227171
Czechoslovakia,TCH,0,0,2,2,1920,Summer,449,0.004454343
New Zealand,NZL,0,0,1,1,1920,Summer,449,0.002227171
United States,USA,45,27,27,99,1924,Summer,392,0.25255102
France,FRA,14,15,12,41,1924,Summer,392,0.104591837
Finland,FIN,14,13,10,37,1924,Summer,392,0.094387755
Great Britain,GBR,9,14,12,35,1924,Summer,392,0.089285714
Italy,ITA,8,3,5,16,1924,Summer,392,0.040816327
Switzerland,SUI,7,8,10,25,1924,Summer,392,0.06377551
Norway,NOR,5,2,3,10,1924,Summer,392,0.025510204
Sweden,SWE,4,13,12,29,1924,Summer,392,0.073979592
Netherlands,NED,4,1,6,11,1924,Summer,392,0.028061224
Belgium,BEL,3,7,3,13,1924,Summer,392,0.033163265
Australia,AUS,3,1,2,6,1924,Summer,392,0.015306122
Denmark,DEN,2,6,3,11,1924,Summer,392,0.028061224
Hungary,HUN,2,4,4,10,1924,Summer,392,0.025510204
Yugoslavia,YUG,2,0,0,2,1924,Summer,392,0.005102041
Czechoslovakia,TCH,1,4,5,10,1924,Summer,392,0.025510204
Argentina,ARG,1,3,2,6,1924,Summer,392,0.015306122
Estonia,EST,1,1,4,6,1924,Summer,392,0.015306122
South Africa,RSA,1,1,1,3,1924,Summer,392,0.007653061
Luxembourg,LUX,1,1,0,2,1924,Summer,392,0.005102041
Greece,GRE,1,0,0,1,1924,Summer,392,0.00255102
Uruguay,URU,1,0,0,1,1924,Summer,392,0.00255102
Austria,AUT,0,3,1,4,1924,Summer,392,0.010204082
Canada,CAN,0,3,1,4,1924,Summer,392,0.010204082
Ireland,IRL,0,1,1,2,1924,Summer,392,0.005102041
Poland,POL,0,1,1,2,1924,Summer,392,0.005102041
Haiti,HAI,0,0,1,1,1924,Summer,392,0.00255102
Japan,JPN,0,0,1,1,1924,Summer,392,0.00255102
Monaco,MON,0,0,1,1,1924,Summer,392,0.00255102
New Zealand,NZL,0,0,1,1,1924,Summer,392,0.00255102
Portugal,POR,0,0,1,1,1924,Summer,392,0.00255102
Romania,ROU,0,0,1,1,1924,Summer,392,0.00255102
United States,USA,22,18,16,56,1928,Summer,356,0.157303371
Germany,GER,11,9,19,39,1928,Summer,356,0.109550562
Netherlands,NED,8,10,5,23,1928,Summer,356,0.064606742
Finland,FIN,8,8,9,25,1928,Summer,356,0.070224719
France,FRA,7,12,6,25,1928,Summer,356,0.070224719
Sweden,SWE,7,6,12,25,1928,Summer,356,0.070224719
Italy,ITA,7,6,7,20,1928,Summer,356,0.056179775
Switzerland,SUI,7,6,4,17,1928,Summer,356,0.047752809
Hungary,HUN,5,5,0,10,1928,Summer,356,0.028089888
Great Britain,GBR,4,11,7,22,1928,Summer,356,0.061797753
Canada,CAN,4,4,7,15,1928,Summer,356,0.042134831
Argentina,ARG,3,3,1,7,1928,Summer,356,0.019662921
Denmark,DEN,3,2,4,9,1928,Summer,356,0.025280899
Austria,AUT,3,0,1,4,1928,Summer,356,0.011235955
Czechoslovakia,TCH,2,5,2,9,1928,Summer,356,0.025280899
Japan,JPN,2,2,1,5,1928,Summer,356,0.014044944
Poland,POL,2,1,4,7,1928,Summer,356,0.019662921
Estonia,EST,2,1,2,5,1928,Summer,356,0.014044944
Egypt,EGY,2,1,1,4,1928,Summer,356,0.011235955
Australia,AUS,1,2,1,4,1928,Summer,356,0.011235955
Norway,NOR,1,2,1,4,1928,Summer,356,0.011235955
Yugoslavia,YUG,1,1,3,5,1928,Summer,356,0.014044944
South Africa,RSA,1,0,2,3,1928,Summer,356,0.008426966
India,IND,1,0,0,1,1928,Summer,356,0.002808989
Ireland,IRL,1,0,0,1,1928,Summer,356,0.002808989
Luxembourg,LUX,1,0,0,1,1928,Summer,356,0.002808989
New Zealand,NZL,1,0,0,1,1928,Summer,356,0.002808989
Spain,ESP,1,0,0,1,1928,Summer,356,0.002808989
Uruguay,URU,1,0,0,1,1928,Summer,356,0.002808989
Belgium,BEL,0,1,2,3,1928,Summer,356,0.008426966
Chile,CHI,0,1,0,1,1928,Summer,356,0.002808989
Haiti,HAI,0,1,0,1,1928,Summer,356,0.002808989
Philippines,PHI,0,0,1,1,1928,Summer,356,0.002808989
Portugal,POR,0,0,1,1,1928,Summer,356,0.002808989
United States,USA,44,36,30,110,1932,Summer,370,0.297297297
Italy,ITA,12,12,12,36,1932,Summer,370,0.097297297
France,FRA,11,5,4,20,1932,Summer,370,0.054054054
Sweden,SWE,10,5,9,24,1932,Summer,370,0.064864865
Japan,JPN,7,7,4,18,1932,Summer,370,0.048648649
Hungary,HUN,6,5,5,16,1932,Summer,370,0.043243243
Germany,GER,5,12,7,24,1932,Summer,370,0.064864865
Finland,FIN,5,8,12,25,1932,Summer,370,0.067567568
Great Britain,GBR,5,7,5,17,1932,Summer,370,0.045945946
Poland,POL,3,2,4,9,1932,Summer,370,0.024324324
Australia,AUS,3,1,1,5,1932,Summer,370,0.013513514
Argentina,ARG,3,1,0,4,1932,Summer,370,0.010810811
Canada,CAN,2,5,9,16,1932,Summer,370,0.043243243
Netherlands,NED,2,5,1,8,1932,Summer,370,0.021621622
South Africa,RSA,2,0,3,5,1932,Summer,370,0.013513514
Ireland,IRL,2,0,0,2,1932,Summer,370,0.005405405
Czechoslovakia,TCH,1,3,2,6,1932,Summer,370,0.016216216
Austria,AUT,1,1,3,5,1932,Summer,370,0.013513514
India,IND,1,0,0,1,1932,Summer,370,0.002702703
Denmark,DEN,0,5,3,8,1932,Summer,370,0.021621622
Mexico,MEX,0,2,0,2,1932,Summer,370,0.005405405
Latvia,LAT,0,1,0,1,1932,Summer,370,0.002702703
New Zealand,NZL,0,1,0,1,1932,Summer,370,0.002702703
Switzerland,SUI,0,1,0,1,1932,Summer,370,0.002702703
Philippines,PHI,0,0,3,3,1932,Summer,370,0.008108108
Belgium,BEL,0,0,1,1,1932,Summer,370,0.002702703
Spain,ESP,0,0,1,1,1932,Summer,370,0.002702703
Uruguay,URU,0,0,1,1,1932,Summer,370,0.002702703
Germany,GER,38,31,32,101,1936,Summer,422,0.239336493
United States,USA,24,21,12,57,1936,Summer,422,0.13507109
Hungary,HUN,10,1,5,16,1936,Summer,422,0.037914692
Italy,ITA,9,13,5,27,1936,Summer,422,0.063981043
Finland,FIN,8,6,6,20,1936,Summer,422,0.047393365
France,FRA,7,6,6,19,1936,Summer,422,0.045023697
Sweden,SWE,6,5,10,21,1936,Summer,422,0.049763033
Japan,JPN,6,4,10,20,1936,Summer,422,0.047393365
Netherlands,NED,6,4,7,17,1936,Summer,422,0.04028436
Austria,AUT,5,7,5,17,1936,Summer,422,0.04028436
Switzerland,SUI,4,9,5,18,1936,Summer,422,0.042654028
Great Britain,GBR,4,7,3,14,1936,Summer,422,0.033175355
Czechoslovakia,TCH,3,5,1,9,1936,Summer,422,0.021327014
Argentina,ARG,2,2,3,7,1936,Summer,422,0.016587678
Estonia,EST,2,2,3,7,1936,Summer,422,0.016587678
Egypt,EGY,2,1,2,5,1936,Summer,422,0.011848341
Canada,CAN,1,3,5,9,1936,Summer,422,0.021327014
Norway,NOR,1,3,2,6,1936,Summer,422,0.014218009
Türkiye,TUR,1,0,1,2,1936,Summer,422,0.004739336
India,IND,1,0,0,1,1936,Summer,422,0.002369668
New Zealand,NZL,1,0,0,1,1936,Summer,422,0.002369668
Poland,POL,0,4,5,9,1936,Summer,422,0.021327014
Denmark,DEN,0,2,3,5,1936,Summer,422,0.011848341
Latvia,LAT,0,1,1,2,1936,Summer,422,0.004739336
Romania,ROU,0,1,0,1,1936,Summer,422,0.002369668
South Africa,RSA,0,1,0,1,1936,Summer,422,0.002369668
Yugoslavia,YUG,0,1,0,1,1936,Summer,422,0.002369668
Belgium,BEL,0,0,3,3,1936,Summer,422,0.007109005
Mexico,MEX,0,0,3,3,1936,Summer,422,0.007109005
Australia,AUS,0,0,1,1,1936,Summer,422,0.002369668
Philippines,PHI,0,0,1,1,1936,Summer,422,0.002369668
Portugal,POR,0,0,1,1,1936,Summer,422,0.002369668
United States,USA,38,27,19,84,1948,Summer,443,0.189616253
Sweden,SWE,17,11,18,46,1948,Summer,443,0.103837472
France,FRA,11,6,15,32,1948,Summer,443,0.072234763
Finland,FIN,10,8,6,24,1948,Summer,443,0.054176072
Hungary,HUN,10,5,13,28,1948,Summer,443,0.063205418
Italy,ITA,9,12,10,31,1948,Summer,443,0.069977427
Türkiye,TUR,6,4,2,12,1948,Summer,443,0.027088036
Czechoslovakia,TCH,6,2,3,11,1948,Summer,443,0.0248307
Switzerland,SUI,5,12,6,23,1948,Summer,443,0.051918736
Denmark,DEN,5,8,9,22,1948,Summer,443,0.0496614
Netherlands,NED,5,2,9,16,1948,Summer,443,0.036117381
Great Britain,GBR,4,16,7,27,1948,Summer,443,0.060948081
Argentina,ARG,3,3,1,7,1948,Summer,443,0.015801354
Australia,AUS,2,6,5,13,1948,Summer,443,0.029345372
Austria,AUT,2,2,4,8,1948,Summer,443,0.018058691
Belgium,BEL,2,2,3,7,1948,Summer,443,0.015801354
South Africa,RSA,2,2,2,6,1948,Summer,443,0.013544018
Egypt,EGY,2,2,1,5,1948,Summer,443,0.011286682
Mexico,MEX,2,1,2,5,1948,Summer,443,0.011286682
Norway,NOR,1,3,3,7,1948,Summer,443,0.015801354
Jamaica,JAM,1,2,0,3,1948,Summer,443,0.006772009
Poland,POL,1,0,1,2,1948,Summer,443,0.004514673
India,IND,1,0,0,1,1948,Summer,443,0.002257336
Peru,PER,1,0,0,1,1948,Summer,443,0.002257336
Canada,CAN,0,2,2,4,1948,Summer,443,0.009029345
Yugoslavia,YUG,0,2,0,2,1948,Summer,443,0.004514673
Portugal,POR,0,1,1,2,1948,Summer,443,0.004514673
Uruguay,URU,0,1,1,2,1948,Summer,443,0.004514673
Cuba,CUB,0,1,0,1,1948,Summer,443,0.002257336
Spain,ESP,0,1,0,1,1948,Summer,443,0.002257336
Sri Lanka,SRI,0,1,0,1,1948,Summer,443,0.002257336
Trinidad and Tobago,TTO,0,1,0,1,1948,Summer,443,0.002257336
Panama,PAN,0,0,2,2,1948,Summer,443,0.004514673
Republic of Korea,KOR,0,0,2,2,1948,Summer,443,0.004514673
Brazil,BRA,0,0,1,1,1948,Summer,443,0.002257336
Ireland,IRL,0,0,1,1,1948,Summer,443,0.002257336
Islamic Republic of Iran,IRI,0,0,1,1,1948,Summer,443,0.002257336
Puerto Rico,PUR,0,0,1,1,1948,Summer,443,0.002257336
United States,USA,40,19,17,76,1952,Summer,459,0.165577342
Soviet Union,URS,22,30,19,71,1952,Summer,459,0.154684096
Hungary,HUN,16,10,16,42,1952,Summer,459,0.091503268
Sweden,SWE,12,13,10,35,1952,Summer,459,0.076252723
Italy,ITA,8,9,4,21,1952,Summer,459,0.045751634
Czechoslovakia,TCH,7,3,3,13,1952,Summer,459,0.02832244
France,FRA,6,6,6,18,1952,Summer,459,0.039215686
Finland,FIN,6,3,13,22,1952,Summer,459,0.047930283
Australia,AUS,6,2,3,11,1952,Summer,459,0.023965142
Norway,NOR,3,2,0,5,1952,Summer,459,0.010893246
Switzerland,SUI,2,6,6,14,1952,Summer,459,0.030501089
South Africa,RSA,2,4,4,10,1952,Summer,459,0.021786492
Jamaica,JAM,2,3,0,5,1952,Summer,459,0.010893246
Belgium,BEL,2,2,0,4,1952,Summer,459,0.008714597
Denmark,DEN,2,1,3,6,1952,Summer,459,0.013071895
Türkiye,TUR,2,0,1,3,1952,Summer,459,0.006535948
Japan,JPN,1,6,2,9,1952,Summer,459,0.019607843
Great Britain,GBR,1,2,8,11,1952,Summer,459,0.023965142
Argentina,ARG,1,2,2,5,1952,Summer,459,0.010893246
Poland,POL,1,2,1,4,1952,Summer,459,0.008714597
Canada,CAN,1,2,0,3,1952,Summer,459,0.006535948
Yugoslavia,YUG,1,2,0,3,1952,Summer,459,0.006535948
Romania,ROU,1,1,2,4,1952,Summer,459,0.008714597
Brazil,BRA,1,0,2,3,1952,Summer,459,0.006535948
New Zealand,NZL,1,0,2,3,1952,Summer,459,0.006535948
India,IND,1,0,1,2,1952,Summer,459,0.004357298
Luxembourg,LUX,1,0,0,1,1952,Summer,459,0.002178649
Germany,GER,0,7,17,24,1952,Summer,459,0.052287582
Netherlands,NED,0,5,0,5,1952,Summer,459,0.010893246
Islamic Republic of Iran,IRI,0,3,4,7,1952,Summer,459,0.015250545
Chile,CHI,0,2,0,2,1952,Summer,459,0.004357298
Austria,AUT,0,1,1,2,1952,Summer,459,0.004357298
Lebanon,LBN,0,1,1,2,1952,Summer,459,0.004357298
Ireland,IRL,0,1,0,1,1952,Summer,459,0.002178649
Mexico,MEX,0,1,0,1,1952,Summer,459,0.002178649
Spain,ESP,0,1,0,1,1952,Summer,459,0.002178649
Republic of Korea,KOR,0,0,2,2,1952,Summer,459,0.004357298
Trinidad and Tobago,TTO,0,0,2,2,1952,Summer,459,0.004357298
Uruguay,URU,0,0,2,2,1952,Summer,459,0.004357298
Bulgaria,BUL,0,0,1,1,1952,Summer,459,0.002178649
Egypt,EGY,0,0,1,1,1952,Summer,459,0.002178649
Portugal,POR,0,0,1,1,1952,Summer,459,0.002178649
Venezuela,VEN,0,0,1,1,1952,Summer,459,0.002178649
Soviet Union,URS,37,29,32,98,1956,Summer,451,0.2172949
United States,USA,32,25,17,74,1956,Summer,451,0.164079823
Australia,AUS,13,8,14,35,1956,Summer,451,0.077605322
Hungary,HUN,9,10,7,26,1956,Summer,451,0.057649667
Italy,ITA,8,6,8,22,1956,Summer,451,0.048780488
Great Britain,GBR,5,7,9,21,1956,Summer,451,0.046563193
Sweden,SWE,5,5,6,16,1956,Summer,451,0.035476718
Romania,ROU,5,3,5,13,1956,Summer,451,0.028824834
Germany,GER,4,10,6,20,1956,Summer,451,0.044345898
Japan,JPN,4,10,5,19,1956,Summer,451,0.042128603
France,FRA,4,4,6,14,1956,Summer,451,0.031042129
Türkiye,TUR,3,2,2,7,1956,Summer,451,0.015521064
Finland,FIN,3,1,11,15,1956,Summer,451,0.033259424
Islamic Republic of Iran,IRI,2,2,1,5,1956,Summer,451,0.011086475
Canada,CAN,2,1,2,5,1956,Summer,451,0.011086475
New Zealand,NZL,2,0,0,2,1956,Summer,451,0.00443459
Poland,POL,1,4,4,9,1956,Summer,451,0.019955654
Czechoslovakia,TCH,1,4,1,6,1956,Summer,451,0.013303769
Bulgaria,BUL,1,3,1,5,1956,Summer,451,0.011086475
Ireland,IRL,1,1,3,5,1956,Summer,451,0.011086475
Denmark,DEN,1,1,1,3,1956,Summer,451,0.006651885
Norway,NOR,1,0,2,3,1956,Summer,451,0.006651885
Mexico,MEX,1,0,1,2,1956,Summer,451,0.00443459
Brazil,BRA,1,0,0,1,1956,Summer,451,0.002217295
India,IND,1,0,0,1,1956,Summer,451,0.002217295
Yugoslavia,YUG,0,3,0,3,1956,Summer,451,0.006651885
Chile,CHI,0,2,2,4,1956,Summer,451,0.00886918
Belgium,BEL,0,2,0,2,1956,Summer,451,0.00443459
Argentina,ARG,0,1,1,2,1956,Summer,451,0.00443459
Republic of Korea,KOR,0,1,1,2,1956,Summer,451,0.00443459
Iceland,ISL,0,1,0,1,1956,Summer,451,0.002217295
Pakistan,PAK,0,1,0,1,1956,Summer,451,0.002217295
South Africa,RSA,0,0,4,4,1956,Summer,451,0.00886918
Austria,AUT,0,0,2,2,1956,Summer,451,0.00443459
Greece,GRE,0,0,1,1,1956,Summer,451,0.002217295
The Bahamas,BAH,0,0,1,1,1956,Summer,451,0.002217295
Uruguay,URU,0,0,1,1,1956,Summer,451,0.002217295
Soviet Union,URS,43,29,31,103,1960,Summer,461,0.223427332
United States,USA,34,21,16,71,1960,Summer,461,0.154013015
Italy,ITA,13,10,13,36,1960,Summer,461,0.078091106
Germany,GER,12,19,11,42,1960,Summer,461,0.091106291
Australia,AUS,8,8,6,22,1960,Summer,461,0.047722343
Türkiye,TUR,7,2,0,9,1960,Summer,461,0.019522777
Hungary,HUN,6,8,7,21,1960,Summer,461,0.045553145
Japan,JPN,4,7,7,18,1960,Summer,461,0.039045553
Poland,POL,4,6,11,21,1960,Summer,461,0.045553145
Czechoslovakia,TCH,3,2,3,8,1960,Summer,461,0.017353579
Romania,ROU,3,1,6,10,1960,Summer,461,0.021691974
Great Britain,GBR,2,6,12,20,1960,Summer,461,0.043383948
Denmark,DEN,2,3,1,6,1960,Summer,461,0.013015184
New Zealand,NZL,2,0,1,3,1960,Summer,461,0.006507592
Bulgaria,BUL,1,3,3,7,1960,Summer,461,0.015184382
Sweden,SWE,1,2,3,6,1960,Summer,461,0.013015184
Finland,FIN,1,1,3,5,1960,Summer,461,0.010845987
Austria,AUT,1,1,0,2,1960,Summer,461,0.004338395
Yugoslavia,YUG,1,1,0,2,1960,Summer,461,0.004338395
Pakistan,PAK,1,0,1,2,1960,Summer,461,0.004338395
Ethiopia,ETH,1,0,0,1,1960,Summer,461,0.002169197
Greece,GRE,1,0,0,1,1960,Summer,461,0.002169197
Norway,NOR,1,0,0,1,1960,Summer,461,0.002169197
Switzerland,SUI,0,3,3,6,1960,Summer,461,0.013015184
France,FRA,0,2,3,5,1960,Summer,461,0.010845987
Belgium,BEL,0,2,2,4,1960,Summer,461,0.00867679
Islamic Republic of Iran,IRI,0,1,3,4,1960,Summer,461,0.00867679
Netherlands,NED,0,1,2,3,1960,Summer,461,0.006507592
South Africa,RSA,0,1,2,3,1960,Summer,461,0.006507592
Argentina,ARG,0,1,1,2,1960,Summer,461,0.004338395
United Arab Republic,UAR,0,1,1,2,1960,Summer,461,0.004338395
Canada,CAN,0,1,0,1,1960,Summer,461,0.002169197
Chinese Taipei,TPE,0,1,0,1,1960,Summer,461,0.002169197
Ghana,GHA,0,1,0,1,1960,Summer,461,0.002169197
India,IND,0,1,0,1,1960,Summer,461,0.002169197
Morocco,MAR,0,1,0,1,1960,Summer,461,0.002169197
Portugal,POR,0,1,0,1,1960,Summer,461,0.002169197
Singapore,SGP,0,1,0,1,1960,Summer,461,0.002169197
Brazil,BRA,0,0,2,2,1960,Summer,461,0.004338395
West Indies Federation,WIF,0,0,2,2,1960,Summer,461,0.004338395
Iraq,IRQ,0,0,1,1,1960,Summer,461,0.002169197
Mexico,MEX,0,0,1,1,1960,Summer,461,0.002169197
Spain,ESP,0,0,1,1,1960,Summer,461,0.002169197
Venezuela,VEN,0,0,1,1,1960,Summer,461,0.002169197
United States,USA,36,26,28,90,1964,Summer,504,0.178571429
Soviet Union,URS,30,31,35,96,1964,Summer,504,0.19047619
Japan,JPN,16,5,8,29,1964,Summer,504,0.057539683
Germany,GER,10,22,18,50,1964,Summer,504,0.099206349
Italy,ITA,10,10,7,27,1964,Summer,504,0.053571429
Hungary,HUN,10,7,5,22,1964,Summer,504,0.043650794
Poland,POL,7,6,10,23,1964,Summer,504,0.045634921
Australia,AUS,6,2,10,18,1964,Summer,504,0.035714286
Czechoslovakia,TCH,5,6,3,14,1964,Summer,504,0.027777778
Great Britain,GBR,4,12,2,18,1964,Summer,504,0.035714286
Bulgaria,BUL,3,5,2,10,1964,Summer,504,0.01984127
Finland,FIN,3,0,2,5,1964,Summer,504,0.009920635
New Zealand,NZL,3,0,2,5,1964,Summer,504,0.009920635
Romania,ROU,2,4,6,12,1964,Summer,504,0.023809524
Netherlands,NED,2,4,4,10,1964,Summer,504,0.01984127
Türkiye,TUR,2,3,1,6,1964,Summer,504,0.011904762
Sweden,SWE,2,2,4,8,1964,Summer,504,0.015873016
Denmark,DEN,2,1,3,6,1964,Summer,504,0.011904762
Yugoslavia,YUG,2,1,2,5,1964,Summer,504,0.009920635
Belgium,BEL,2,0,1,3,1964,Summer,504,0.005952381
France,FRA,1,8,6,15,1964,Summer,504,0.029761905
Canada,CAN,1,2,1,4,1964,Summer,504,0.007936508
Switzerland,SUI,1,2,1,4,1964,Summer,504,0.007936508
Ethiopia,ETH,1,0,0,1,1964,Summer,504,0.001984127
India,IND,1,0,0,1,1964,Summer,504,0.001984127
The Bahamas,BAH,1,0,0,1,1964,Summer,504,0.001984127
Republic of Korea,KOR,0,2,1,3,1964,Summer,504,0.005952381
Trinidad and Tobago,TTO,0,1,2,3,1964,Summer,504,0.005952381
Tunisia,TUN,0,1,1,2,1964,Summer,504,0.003968254
Argentina,ARG,0,1,0,1,1964,Summer,504,0.001984127
Cuba,CUB,0,1,0,1,1964,Summer,504,0.001984127
Pakistan,PAK,0,1,0,1,1964,Summer,504,0.001984127
Philippines,PHI,0,1,0,1,1964,Summer,504,0.001984127
Islamic Republic of Iran,IRI,0,0,2,2,1964,Summer,504,0.003968254
Brazil,BRA,0,0,1,1,1964,Summer,504,0.001984127
Ghana,GHA,0,0,1,1,1964,Summer,504,0.001984127
Ireland,IRL,0,0,1,1,1964,Summer,504,0.001984127
Kenya,KEN,0,0,1,1,1964,Summer,504,0.001984127
Mexico,MEX,0,0,1,1,1964,Summer,504,0.001984127
Nigeria,NGR,0,0,1,1,1964,Summer,504,0.001984127
Uruguay,URU,0,0,1,1,1964,Summer,504,0.001984127
United States,USA,45,28,34,107,1968,Summer,527,0.203036053
Soviet Union,URS,29,32,30,91,1968,Summer,527,0.172675522
Japan,JPN,11,7,7,25,1968,Summer,527,0.04743833
Hungary,HUN,10,10,12,32,1968,Summer,527,0.060721063
East Germany,GDR,9,9,7,25,1968,Summer,527,0.04743833
France,FRA,7,3,5,15,1968,Summer,527,0.028462998
Czechoslovakia,TCH,7,2,4,13,1968,Summer,527,0.024667932
West Germany,FRG,5,11,10,26,1968,Summer,527,0.049335863
Australia,AUS,5,7,5,17,1968,Summer,527,0.032258065
Great Britain,GBR,5,5,3,13,1968,Summer,527,0.024667932
Poland,POL,5,2,11,18,1968,Summer,527,0.034155598
Romania,ROU,4,6,5,15,1968,Summer,527,0.028462998
Italy,ITA,3,4,9,16,1968,Summer,527,0.030360531
Kenya,KEN,3,4,2,9,1968,Summer,527,0.017077799
Mexico,MEX,3,3,3,9,1968,Summer,527,0.017077799
Yugoslavia,YUG,3,3,2,8,1968,Summer,527,0.015180266
Netherlands,NED,3,3,1,7,1968,Summer,527,0.013282732
Bulgaria,BUL,2,4,3,9,1968,Summer,527,0.017077799
Islamic Republic of Iran,IRI,2,1,2,5,1968,Summer,527,0.009487666
Sweden,SWE,2,1,1,4,1968,Summer,527,0.007590133
Türkiye,TUR,2,0,0,2,1968,Summer,527,0.003795066
Denmark,DEN,1,4,3,8,1968,Summer,527,0.015180266
Canada,CAN,1,3,1,5,1968,Summer,527,0.009487666
Finland,FIN,1,2,1,4,1968,Summer,527,0.007590133
Ethiopia,ETH,1,1,0,2,1968,Summer,527,0.003795066
Norway,NOR,1,1,0,2,1968,Summer,527,0.003795066
New Zealand,NZL,1,0,2,3,1968,Summer,527,0.0056926
Tunisia,TUN,1,0,1,2,1968,Summer,527,0.003795066
Pakistan,PAK,1,0,0,1,1968,Summer,527,0.001897533
Venezuela,VEN,1,0,0,1,1968,Summer,527,0.001897533
Cuba,CUB,0,4,0,4,1968,Summer,527,0.007590133
Austria,AUT,0,2,2,4,1968,Summer,527,0.007590133
Switzerland,SUI,0,1,4,5,1968,Summer,527,0.009487666
Mongolia,MGL,0,1,3,4,1968,Summer,527,0.007590133
Brazil,BRA,0,1,2,3,1968,Summer,527,0.0056926
Belgium,BEL,0,1,1,2,1968,Summer,527,0.003795066
Republic of Korea,KOR,0,1,1,2,1968,Summer,527,0.003795066
Uganda,UGA,0,1,1,2,1968,Summer,527,0.003795066
Cameroon,CMR,0,1,0,1,1968,Summer,527,0.001897533
Jamaica,JAM,0,1,0,1,1968,Summer,527,0.001897533
Argentina,ARG,0,0,2,2,1968,Summer,527,0.003795066
Chinese Taipei,TPE,0,0,1,1,1968,Summer,527,0.001897533
Greece,GRE,0,0,1,1,1968,Summer,527,0.001897533
India,IND,0,0,1,1,1968,Summer,527,0.001897533
Soviet Union,URS,50,27,22,99,1972,Summer,600,0.165
United States,USA,33,31,30,94,1972,Summer,600,0.156666667
East Germany,GDR,20,23,23,66,1972,Summer,600,0.11
West Germany,FRG,13,11,16,40,1972,Summer,600,0.066666667
Japan,JPN,13,8,8,29,1972,Summer,600,0.048333333
Australia,AUS,8,7,2,17,1972,Summer,600,0.028333333
Poland,POL,7,5,9,21,1972,Summer,600,0.035
Hungary,HUN,6,13,16,35,1972,Summer,600,0.058333333
Bulgaria,BUL,6,10,5,21,1972,Summer,600,0.035
Italy,ITA,5,3,10,18,1972,Summer,600,0.03
Sweden,SWE,4,6,6,16,1972,Summer,600,0.026666667
Great Britain,GBR,4,5,9,18,1972,Summer,600,0.03
Romania,ROU,3,6,7,16,1972,Summer,600,0.026666667
Cuba,CUB,3,1,4,8,1972,Summer,600,0.013333333
Finland,FIN,3,1,4,8,1972,Summer,600,0.013333333
Netherlands,NED,3,1,1,5,1972,Summer,600,0.008333333
France,FRA,2,4,7,13,1972,Summer,600,0.021666667
Czechoslovakia,TCH,2,4,2,8,1972,Summer,600,0.013333333
Kenya,KEN,2,3,4,9,1972,Summer,600,0.015
Yugoslavia,YUG,2,1,2,5,1972,Summer,600,0.008333333
Norway,NOR,2,1,1,4,1972,Summer,600,0.006666667
Democratic People's Republic of Korea,PRK,1,1,3,5,1972,Summer,600,0.008333333
New Zealand,NZL,1,1,1,3,1972,Summer,600,0.005
Uganda,UGA,1,1,0,2,1972,Summer,600,0.003333333
Denmark,DEN,1,0,0,1,1972,Summer,600,0.001666667
Switzerland,SUI,0,3,0,3,1972,Summer,600,0.005
Canada,CAN,0,2,3,5,1972,Summer,600,0.008333333
Islamic Republic of Iran,IRI,0,2,1,3,1972,Summer,600,0.005
Belgium,BEL,0,2,0,2,1972,Summer,600,0.003333333
Greece,GRE,0,2,0,2,1972,Summer,600,0.003333333
Austria,AUT,0,1,2,3,1972,Summer,600,0.005
Colombia,COL,0,1,2,3,1972,Summer,600,0.005
Argentina,ARG,0,1,0,1,1972,Summer,600,0.001666667
Lebanon,LBN,0,1,0,1,1972,Summer,600,0.001666667
Mexico,MEX,0,1,0,1,1972,Summer,600,0.001666667
Mongolia,MGL,0,1,0,1,1972,Summer,600,0.001666667
Pakistan,PAK,0,1,0,1,1972,Summer,600,0.001666667
Republic of Korea,KOR,0,1,0,1,1972,Summer,600,0.001666667
Tunisia,TUN,0,1,0,1,1972,Summer,600,0.001666667
Türkiye,TUR,0,1,0,1,1972,Summer,600,0.001666667
Brazil,BRA,0,0,2,2,1972,Summer,600,0.003333333
Ethiopia,ETH,0,0,2,2,1972,Summer,600,0.003333333
Ghana,GHA,0,0,1,1,1972,Summer,600,0.001666667
India,IND,0,0,1,1,1972,Summer,600,0.001666667
Jamaica,JAM,0,0,1,1,1972,Summer,600,0.001666667
Niger,NIG,0,0,1,1,1972,Summer,600,0.001666667
Nigeria,NGR,0,0,1,1,1972,Summer,600,0.001666667
Spain,ESP,0,0,1,1,1972,Summer,600,0.001666667
Soviet Union,URS,49,41,35,125,1976,Summer,613,0.203915171
East Germany,GDR,40,25,25,90,1976,Summer,613,0.146818923
United States,USA,34,35,25,94,1976,Summer,613,0.153344209
West Germany,FRG,10,12,17,39,1976,Summer,613,0.063621533
Japan,JPN,9,6,10,25,1976,Summer,613,0.040783034
Poland,POL,7,6,13,26,1976,Summer,613,0.042414356
Bulgaria,BUL,6,9,7,22,1976,Summer,613,0.03588907
Cuba,CUB,6,4,3,13,1976,Summer,613,0.021207178
Romania,ROU,4,9,14,27,1976,Summer,613,0.044045677
Hungary,HUN,4,5,13,22,1976,Summer,613,0.03588907
Finland,FIN,4,2,0,6,1976,Summer,613,0.009787928
Sweden,SWE,4,1,0,5,1976,Summer,613,0.008156607
Great Britain,GBR,3,5,5,13,1976,Summer,613,0.021207178
Italy,ITA,2,7,4,13,1976,Summer,613,0.021207178
France,FRA,2,3,4,9,1976,Summer,613,0.014681892
Yugoslavia,YUG,2,3,3,8,1976,Summer,613,0.013050571
Czechoslovakia,TCH,2,2,4,8,1976,Summer,613,0.013050571
New Zealand,NZL,2,1,1,4,1976,Summer,613,0.006525285
Republic of Korea,KOR,1,1,4,6,1976,Summer,613,0.009787928
Switzerland,SUI,1,1,2,4,1976,Summer,613,0.006525285
Democratic People's Republic of Korea,PRK,1,1,0,2,1976,Summer,613,0.003262643
Jamaica,JAM,1,1,0,2,1976,Summer,613,0.003262643
Norway,NOR,1,1,0,2,1976,Summer,613,0.003262643
Denmark,DEN,1,0,2,3,1976,Summer,613,0.004893964
Mexico,MEX,1,0,1,2,1976,Summer,613,0.003262643
Trinidad and Tobago,TTO,1,0,0,1,1976,Summer,613,0.001631321
Canada,CAN,0,5,6,11,1976,Summer,613,0.017944535
Belgium,BEL,0,3,3,6,1976,Summer,613,0.009787928
Netherlands,NED,0,2,3,5,1976,Summer,613,0.008156607
Portugal,POR,0,2,0,2,1976,Summer,613,0.003262643
Spain,ESP,0,2,0,2,1976,Summer,613,0.003262643
Australia,AUS,0,1,4,5,1976,Summer,613,0.008156607
Islamic Republic of Iran,IRI,0,1,1,2,1976,Summer,613,0.003262643
Mongolia,MGL,0,1,0,1,1976,Summer,613,0.001631321
Venezuela,VEN,0,1,0,1,1976,Summer,613,0.001631321
Brazil,BRA,0,0,2,2,1976,Summer,613,0.003262643
Austria,AUT,0,0,1,1,1976,Summer,613,0.001631321
Bermuda,BER,0,0,1,1,1976,Summer,613,0.001631321
Pakistan,PAK,0,0,1,1,1976,Summer,613,0.001631321
Puerto Rico,PUR,0,0,1,1,1976,Summer,613,0.001631321
Thailand,THA,0,0,1,1,1976,Summer,613,0.001631321
Soviet Union,URS,80,69,46,195,1980,Summer,631,0.309033281
East Germany,GDR,47,37,42,126,1980,Summer,631,0.199683043
Bulgaria,BUL,8,16,17,41,1980,Summer,631,0.064976228
Cuba,CUB,8,7,5,20,1980,Summer,631,0.031695721
Italy,ITA,8,3,4,15,1980,Summer,631,0.023771791
Hungary,HUN,7,10,15,32,1980,Summer,631,0.050713154
Romania,ROU,6,6,13,25,1980,Summer,631,0.039619651
France,FRA,6,5,3,14,1980,Summer,631,0.022187005
Great Britain,GBR,5,7,9,21,1980,Summer,631,0.033280507
Poland,POL,3,14,15,32,1980,Summer,631,0.050713154
Sweden,SWE,3,3,6,12,1980,Summer,631,0.019017433
Finland,FIN,3,1,4,8,1980,Summer,631,0.012678288
Czechoslovakia,TCH,2,3,9,14,1980,Summer,631,0.022187005
Yugoslavia,YUG,2,3,4,9,1980,Summer,631,0.014263074
Australia,AUS,2,2,5,9,1980,Summer,631,0.014263074
Denmark,DEN,2,1,2,5,1980,Summer,631,0.00792393
Brazil,BRA,2,0,2,4,1980,Summer,631,0.006339144
Ethiopia,ETH,2,0,2,4,1980,Summer,631,0.006339144
Switzerland,SUI,2,0,0,2,1980,Summer,631,0.003169572
Spain,ESP,1,3,2,6,1980,Summer,631,0.009508716
Austria,AUT,1,2,1,4,1980,Summer,631,0.006339144
Greece,GRE,1,0,2,3,1980,Summer,631,0.004754358
Belgium,BEL,1,0,0,1,1980,Summer,631,0.001584786
India,IND,1,0,0,1,1980,Summer,631,0.001584786
Zimbabwe,ZIM,1,0,0,1,1980,Summer,631,0.001584786
Democratic People's Republic of Korea,PRK,0,3,2,5,1980,Summer,631,0.00792393
Mongolia,MGL,0,2,2,4,1980,Summer,631,0.006339144
United Republic of Tanzania,TAN,0,2,0,2,1980,Summer,631,0.003169572
Mexico,MEX,0,1,3,4,1980,Summer,631,0.006339144
Netherlands,NED,0,1,2,3,1980,Summer,631,0.004754358
Ireland,IRL,0,1,1,2,1980,Summer,631,0.003169572
Uganda,UGA,0,1,0,1,1980,Summer,631,0.001584786
Venezuela,VEN,0,1,0,1,1980,Summer,631,0.001584786
Jamaica,JAM,0,0,3,3,1980,Summer,631,0.004754358
Guyana,GUY,0,0,1,1,1980,Summer,631,0.001584786
Lebanon,LBN,0,0,1,1,1980,Summer,631,0.001584786
United States,USA,83,61,30,174,1984,Summer,688,0.252906977
Romania,ROU,20,16,17,53,1984,Summer,688,0.077034884
West Germany,FRG,17,19,23,59,1984,Summer,688,0.085755814
People's Republic of China,CHN,15,8,9,32,1984,Summer,688,0.046511628
Italy,ITA,14,6,12,32,1984,Summer,688,0.046511628
Canada,CAN,10,18,16,44,1984,Summer,688,0.063953488
Japan,JPN,10,8,14,32,1984,Summer,688,0.046511628
New Zealand,NZL,8,1,2,11,1984,Summer,688,0.015988372
Yugoslavia,YUG,7,4,7,18,1984,Summer,688,0.026162791
Republic of Korea,KOR,6,6,7,19,1984,Summer,688,0.027616279
Great Britain,GBR,5,11,21,37,1984,Summer,688,0.05377907
France,FRA,5,7,16,28,1984,Summer,688,0.040697674
Netherlands,NED,5,2,6,13,1984,Summer,688,0.018895349
Australia,AUS,4,8,12,24,1984,Summer,688,0.034883721
Finland,FIN,4,2,6,12,1984,Summer,688,0.01744186
Sweden,SWE,2,11,6,19,1984,Summer,688,0.027616279
Mexico,MEX,2,3,1,6,1984,Summer,688,0.00872093
Morocco,MAR,2,0,0,2,1984,Summer,688,0.002906977
Brazil,BRA,1,5,2,8,1984,Summer,688,0.011627907
Spain,ESP,1,2,2,5,1984,Summer,688,0.007267442
Belgium,BEL,1,1,2,4,1984,Summer,688,0.005813953
Austria,AUT,1,1,1,3,1984,Summer,688,0.004360465
Kenya,KEN,1,0,2,3,1984,Summer,688,0.004360465
Portugal,POR,1,0,2,3,1984,Summer,688,0.004360465
Pakistan,PAK,1,0,0,1,1984,Summer,688,0.001453488
Switzerland,SUI,0,4,4,8,1984,Summer,688,0.011627907
Denmark,DEN,0,3,3,6,1984,Summer,688,0.00872093
Jamaica,JAM,0,1,2,3,1984,Summer,688,0.004360465
Norway,NOR,0,1,2,3,1984,Summer,688,0.004360465
Greece,GRE,0,1,1,2,1984,Summer,688,0.002906977
Nigeria,NGR,0,1,1,2,1984,Summer,688,0.002906977
Puerto Rico,PUR,0,1,1,2,1984,Summer,688,0.002906977
Colombia,COL,0,1,0,1,1984,Summer,688,0.001453488
Côte d'Ivoire,CIV,0,1,0,1,1984,Summer,688,0.001453488
Egypt,EGY,0,1,0,1,1984,Summer,688,0.001453488
Ireland,IRL,0,1,0,1,1984,Summer,688,0.001453488
Peru,PER,0,1,0,1,1984,Summer,688,0.001453488
Syrian Arab Republic,SYR,0,1,0,1,1984,Summer,688,0.001453488
Thailand,THA,0,1,0,1,1984,Summer,688,0.001453488
Türkiye,TUR,0,0,3,3,1984,Summer,688,0.004360465
Venezuela,VEN,0,0,3,3,1984,Summer,688,0.004360465
Algeria,ALG,0,0,2,2,1984,Summer,688,0.002906977
Cameroon,CMR,0,0,1,1,1984,Summer,688,0.001453488
Chinese Taipei,TPE,0,0,1,1,1984,Summer,688,0.001453488
Dominican Republic,DOM,0,0,1,1,1984,Summer,688,0.001453488
Iceland,ISL,0,0,1,1,1984,Summer,688,0.001453488
Zambia,ZAM,0,0,1,1,1984,Summer,688,0.001453488
Soviet Union,URS,55,31,46,132,1988,Summer,739,0.178619756
East Germany,GDR,37,35,30,102,1988,Summer,739,0.138024357
United States,USA,36,31,27,94,1988,Summer,739,0.127198917
Republic of Korea,KOR,12,10,11,33,1988,Summer,739,0.044654939
West Germany,FRG,11,14,15,40,1988,Summer,739,0.054127199
Hungary,HUN,11,6,6,23,1988,Summer,739,0.031123139
Bulgaria,BUL,10,12,13,35,1988,Summer,739,0.047361299
Romania,ROU,7,11,6,24,1988,Summer,739,0.032476319
France,FRA,6,4,6,16,1988,Summer,739,0.02165088
Italy,ITA,6,4,4,14,1988,Summer,739,0.01894452
People's Republic of China,CHN,5,11,12,28,1988,Summer,739,0.037889039
Great Britain,GBR,5,10,9,24,1988,Summer,739,0.032476319
Kenya,KEN,5,2,2,9,1988,Summer,739,0.01217862
Japan,JPN,4,3,7,14,1988,Summer,739,0.01894452
Australia,AUS,3,6,5,14,1988,Summer,739,0.01894452
Yugoslavia,YUG,3,4,5,12,1988,Summer,739,0.01623816
Czechoslovakia,TCH,3,3,2,8,1988,Summer,739,0.01082544
New Zealand,NZL,3,2,8,13,1988,Summer,739,0.01759134
Canada,CAN,3,2,5,10,1988,Summer,739,0.0135318
Poland,POL,2,5,9,16,1988,Summer,739,0.02165088
Norway,NOR,2,3,0,5,1988,Summer,739,0.0067659
Netherlands,NED,2,2,5,9,1988,Summer,739,0.01217862
Denmark,DEN,2,1,1,4,1988,Summer,739,0.00541272
Brazil,BRA,1,2,3,6,1988,Summer,739,0.00811908
Finland,FIN,1,1,2,4,1988,Summer,739,0.00541272
Spain,ESP,1,1,2,4,1988,Summer,739,0.00541272
Türkiye,TUR,1,1,0,2,1988,Summer,739,0.00270636
Morocco,MAR,1,0,2,3,1988,Summer,739,0.00405954
Austria,AUT,1,0,0,1,1988,Summer,739,0.00135318
Portugal,POR,1,0,0,1,1988,Summer,739,0.00135318
Suriname,SUR,1,0,0,1,1988,Summer,739,0.00135318
Sweden,SWE,0,4,7,11,1988,Summer,739,0.01488498
Switzerland,SUI,0,2,2,4,1988,Summer,739,0.00541272
Jamaica,JAM,0,2,0,2,1988,Summer,739,0.00270636
Argentina,ARG,0,1,1,2,1988,Summer,739,0.00270636
Chile,CHI,0,1,0,1,1988,Summer,739,0.00135318
Costa Rica,CRC,0,1,0,1,1988,Summer,739,0.00135318
Indonesia,INA,0,1,0,1,1988,Summer,739,0.00135318
Islamic Republic of Iran,IRI,0,1,0,1,1988,Summer,739,0.00135318
Netherlands Antilles,AHO,0,1,0,1,1988,Summer,739,0.00135318
Peru,PER,0,1,0,1,1988,Summer,739,0.00135318
Senegal,SEN,0,1,0,1,1988,Summer,739,0.00135318
United States Virgin Islands,ISV,0,1,0,1,1988,Summer,739,0.00135318
Belgium,BEL,0,0,2,2,1988,Summer,739,0.00270636
Mexico,MEX,0,0,2,2,1988,Summer,739,0.00270636
Colombia,COL,0,0,1,1,1988,Summer,739,0.00135318
Djibouti,DJI,0,0,1,1,1988,Summer,739,0.00135318
Greece,GRE,0,0,1,1,1988,Summer,739,0.00135318
Mongolia,MGL,0,0,1,1,1988,Summer,739,0.00135318
Pakistan,PAK,0,0,1,1,1988,Summer,739,0.00135318
Philippines,PHI,0,0,1,1,1988,Summer,739,0.00135318
Thailand,THA,0,0,1,1,1988,Summer,739,0.00135318
Unified Team,EUN,45,38,29,112,1992,Summer,815,0.137423313
United States,USA,37,34,37,108,1992,Summer,815,0.132515337
Germany,GER,33,21,28,82,1992,Summer,815,0.100613497
People's Republic of China,CHN,16,22,16,54,1992,Summer,815,0.066257669
Cuba,CUB,14,6,11,31,1992,Summer,815,0.03803681
Spain,ESP,13,7,2,22,1992,Summer,815,0.026993865
Republic of Korea,KOR,12,5,12,29,1992,Summer,815,0.035582822
Hungary,HUN,11,12,7,30,1992,Summer,815,0.036809816
France,FRA,8,5,16,29,1992,Summer,815,0.035582822
Australia,AUS,7,9,11,27,1992,Summer,815,0.033128834
Canada,CAN,7,4,7,18,1992,Summer,815,0.02208589
Italy,ITA,6,5,8,19,1992,Summer,815,0.023312883
Great Britain,GBR,5,3,12,20,1992,Summer,815,0.024539877
Romania,ROU,4,6,8,18,1992,Summer,815,0.02208589
Czechoslovakia,TCH,4,2,1,7,1992,Summer,815,0.008588957
Democratic People's Republic of Korea,PRK,4,0,5,9,1992,Summer,815,0.011042945
Japan,JPN,3,8,11,22,1992,Summer,815,0.026993865
Bulgaria,BUL,3,7,6,16,1992,Summer,815,0.019631902
Poland,POL,3,6,10,19,1992,Summer,815,0.023312883
Netherlands,NED,2,6,7,15,1992,Summer,815,0.018404908
Kenya,KEN,2,4,2,8,1992,Summer,815,0.009815951
Norway,NOR,2,4,1,7,1992,Summer,815,0.008588957
Türkiye,TUR,2,2,2,6,1992,Summer,815,0.007361963
Indonesia,INA,2,2,1,5,1992,Summer,815,0.006134969
Brazil,BRA,2,1,0,3,1992,Summer,815,0.003680982
Greece,GRE,2,0,0,2,1992,Summer,815,0.002453988
Sweden,SWE,1,7,4,12,1992,Summer,815,0.014723926
New Zealand,NZL,1,4,5,10,1992,Summer,815,0.012269939
Finland,FIN,1,2,2,5,1992,Summer,815,0.006134969
Denmark,DEN,1,1,4,6,1992,Summer,815,0.007361963
Morocco,MAR,1,1,1,3,1992,Summer,815,0.003680982
Ireland,IRL,1,1,0,2,1992,Summer,815,0.002453988
Ethiopia,ETH,1,0,2,3,1992,Summer,815,0.003680982
Algeria,ALG,1,0,1,2,1992,Summer,815,0.002453988
Estonia,EST,1,0,1,2,1992,Summer,815,0.002453988
Lithuania,LTU,1,0,1,2,1992,Summer,815,0.002453988
Switzerland,SUI,1,0,0,1,1992,Summer,815,0.001226994
Jamaica,JAM,0,3,1,4,1992,Summer,815,0.004907975
Nigeria,NGR,0,3,1,4,1992,Summer,815,0.004907975
Latvia,LAT,0,2,1,3,1992,Summer,815,0.003680982
Austria,AUT,0,2,0,2,1992,Summer,815,0.002453988
Namibia,NAM,0,2,0,2,1992,Summer,815,0.002453988
South Africa,RSA,0,2,0,2,1992,Summer,815,0.002453988
Belgium,BEL,0,1,2,3,1992,Summer,815,0.003680982
Croatia,CRO,0,1,2,3,1992,Summer,815,0.003680982
Independent Olympic Athletes,IOA,0,1,2,3,1992,Summer,815,0.003680982
Islamic Republic of Iran,IRI,0,1,2,3,1992,Summer,815,0.003680982
Israel,ISR,0,1,1,2,1992,Summer,815,0.002453988
Chinese Taipei,TPE,0,1,0,1,1992,Summer,815,0.001226994
Mexico,MEX,0,1,0,1,1992,Summer,815,0.001226994
Peru,PER,0,1,0,1,1992,Summer,815,0.001226994
Mongolia,MGL,0,0,2,2,1992,Summer,815,0.002453988
Slovenia,SLO,0,0,2,2,1992,Summer,815,0.002453988
Argentina,ARG,0,0,1,1,1992,Summer,815,0.001226994
Colombia,COL,0,0,1,1,1992,Summer,815,0.001226994
Ghana,GHA,0,0,1,1,1992,Summer,815,0.001226994
Malaysia,MAS,0,0,1,1,1992,Summer,815,0.001226994
Pakistan,PAK,0,0,1,1,1992,Summer,815,0.001226994
Philippines,PHI,0,0,1,1,1992,Summer,815,0.001226994
Puerto Rico,PUR,0,0,1,1,1992,Summer,815,0.001226994
Qatar,QAT,0,0,1,1,1992,Summer,815,0.001226994
Suriname,SUR,0,0,1,1,1992,Summer,815,0.001226994
Thailand,THA,0,0,1,1,1992,Summer,815,0.001226994
The Bahamas,BAH,0,0,1,1,1992,Summer,815,0.001226994
United States,USA,44,32,25,101,1996,Summer,842,0.119952494
Russian Federation,RUS,26,21,16,63,1996,Summer,842,0.074821853
Germany,GER,20,18,27,65,1996,Summer,842,0.07719715
People's Republic of China,CHN,16,22,12,50,1996,Summer,842,0.059382423
France,FRA,15,7,15,37,1996,Summer,842,0.043942993
Italy,ITA,13,10,12,35,1996,Summer,842,0.041567696
Australia,AUS,9,9,23,41,1996,Summer,842,0.048693587
Cuba,CUB,9,8,8,25,1996,Summer,842,0.029691211
Ukraine,UKR,9,2,12,23,1996,Summer,842,0.027315914
Republic of Korea,KOR,7,15,5,27,1996,Summer,842,0.032066508
Poland,POL,7,5,5,17,1996,Summer,842,0.020190024
Hungary,HUN,7,4,10,21,1996,Summer,842,0.024940618
Spain,ESP,5,6,6,17,1996,Summer,842,0.020190024
Romania,ROU,4,7,9,20,1996,Summer,842,0.023752969
Netherlands,NED,4,5,10,19,1996,Summer,842,0.022565321
Greece,GRE,4,4,0,8,1996,Summer,842,0.009501188
Czechia,CZE,4,3,4,11,1996,Summer,842,0.013064133
Switzerland,SUI,4,3,0,7,1996,Summer,842,0.008313539
Denmark,DEN,4,1,1,6,1996,Summer,842,0.007125891
Türkiye,TUR,4,1,1,6,1996,Summer,842,0.007125891
Canada,CAN,3,11,8,22,1996,Summer,842,0.026128266
Bulgaria,BUL,3,7,5,15,1996,Summer,842,0.017814727
Japan,JPN,3,6,5,14,1996,Summer,842,0.016627078
Kazakhstan,KAZ,3,4,4,11,1996,Summer,842,0.013064133
Brazil,BRA,3,3,9,15,1996,Summer,842,0.017814727
New Zealand,NZL,3,2,1,6,1996,Summer,842,0.007125891
South Africa,RSA,3,1,1,5,1996,Summer,842,0.005938242
Ireland,IRL,3,0,1,4,1996,Summer,842,0.004750594
Sweden,SWE,2,4,2,8,1996,Summer,842,0.009501188
Norway,NOR,2,2,3,7,1996,Summer,842,0.008313539
Belgium,BEL,2,2,2,6,1996,Summer,842,0.007125891
Nigeria,NGR,2,1,3,6,1996,Summer,842,0.007125891
Democratic People's Republic of Korea,PRK,2,1,2,5,1996,Summer,842,0.005938242
Algeria,ALG,2,0,1,3,1996,Summer,842,0.003562945
Ethiopia,ETH,2,0,1,3,1996,Summer,842,0.003562945
Great Britain,GBR,1,8,6,15,1996,Summer,842,0.017814727
Belarus,BLR,1,6,8,15,1996,Summer,842,0.017814727
Kenya,KEN,1,4,3,8,1996,Summer,842,0.009501188
Jamaica,JAM,1,3,2,6,1996,Summer,842,0.007125891
Finland,FIN,1,2,1,4,1996,Summer,842,0.004750594
Indonesia,INA,1,1,2,4,1996,Summer,842,0.004750594
Serbia and Montenegro,SCG,1,1,2,4,1996,Summer,842,0.004750594
Islamic Republic of Iran,IRI,1,1,1,3,1996,Summer,842,0.003562945
Slovakia,SVK,1,1,1,3,1996,Summer,842,0.003562945
Armenia,ARM,1,1,0,2,1996,Summer,842,0.002375297
Croatia,CRO,1,1,0,2,1996,Summer,842,0.002375297
Portugal,POR,1,0,1,2,1996,Summer,842,0.002375297
Thailand,THA,1,0,1,2,1996,Summer,842,0.002375297
Burundi,BDI,1,0,0,1,1996,Summer,842,0.001187648
Costa Rica,CRC,1,0,0,1,1996,Summer,842,0.001187648
Ecuador,ECU,1,0,0,1,1996,Summer,842,0.001187648
"Hong Kong, China",HKG,1,0,0,1,1996,Summer,842,0.001187648
Syrian Arab Republic,SYR,1,0,0,1,1996,Summer,842,0.001187648
Argentina,ARG,0,2,1,3,1996,Summer,842,0.003562945
Namibia,NAM,0,2,0,2,1996,Summer,842,0.002375297
Slovenia,SLO,0,2,0,2,1996,Summer,842,0.002375297
Austria,AUT,0,1,2,3,1996,Summer,842,0.003562945
Malaysia,MAS,0,1,1,2,1996,Summer,842,0.002375297
Republic of Moldova,MDA,0,1,1,2,1996,Summer,842,0.002375297
Uzbekistan,UZB,0,1,1,2,1996,Summer,842,0.002375297
Azerbaijan,AZE,0,1,0,1,1996,Summer,842,0.001187648
Chinese Taipei,TPE,0,1,0,1,1996,Summer,842,0.001187648
Latvia,LAT,0,1,0,1,1996,Summer,842,0.001187648
Philippines,PHI,0,1,0,1,1996,Summer,842,0.001187648
The Bahamas,BAH,0,1,0,1,1996,Summer,842,0.001187648
Tonga,TGA,0,1,0,1,1996,Summer,842,0.001187648
Zambia,ZAM,0,1,0,1,1996,Summer,842,0.001187648
Georgia,GEO,0,0,2,2,1996,Summer,842,0.002375297
Morocco,MAR,0,0,2,2,1996,Summer,842,0.002375297
Trinidad and Tobago,TTO,0,0,2,2,1996,Summer,842,0.002375297
India,IND,0,0,1,1,1996,Summer,842,0.001187648
Israel,ISR,0,0,1,1,1996,Summer,842,0.001187648
Lithuania,LTU,0,0,1,1,1996,Summer,842,0.001187648
Mexico,MEX,0,0,1,1,1996,Summer,842,0.001187648
Mongolia,MGL,0,0,1,1,1996,Summer,842,0.001187648
Mozambique,MOZ,0,0,1,1,1996,Summer,842,0.001187648
Puerto Rico,PUR,0,0,1,1,1996,Summer,842,0.001187648
Tunisia,TUN,0,0,1,1,1996,Summer,842,0.001187648
Uganda,UGA,0,0,1,1,1996,Summer,842,0.001187648
United States,USA,37,24,32,93,2000,Summer,927,0.100323625
Russian Federation,RUS,32,28,29,89,2000,Summer,927,0.09600863
People's Republic of China,CHN,28,16,14,58,2000,Summer,927,0.062567422
Australia,AUS,16,25,17,58,2000,Summer,927,0.062567422
Germany,GER,13,17,26,56,2000,Summer,927,0.060409924
France,FRA,13,14,11,38,2000,Summer,927,0.040992449
Italy,ITA,13,8,13,34,2000,Summer,927,0.036677454
Netherlands,NED,12,9,4,25,2000,Summer,927,0.026968716
Cuba,CUB,11,11,7,29,2000,Summer,927,0.031283711
Great Britain,GBR,11,10,7,28,2000,Summer,927,0.030204962
Romania,ROU,11,6,9,26,2000,Summer,927,0.028047465
Republic of Korea,KOR,8,10,10,28,2000,Summer,927,0.030204962
Hungary,HUN,8,6,3,17,2000,Summer,927,0.018338727
Poland,POL,6,5,3,14,2000,Summer,927,0.015102481
Japan,JPN,5,8,5,18,2000,Summer,927,0.019417476
Bulgaria,BUL,5,6,2,13,2000,Summer,927,0.014023732
Greece,GRE,4,6,3,13,2000,Summer,927,0.014023732
Sweden,SWE,4,5,3,12,2000,Summer,927,0.012944984
Norway,NOR,4,3,3,10,2000,Summer,927,0.010787487
Ethiopia,ETH,4,1,3,8,2000,Summer,927,0.008629989
Ukraine,UKR,3,10,10,23,2000,Summer,927,0.024811219
Kazakhstan,KAZ,3,4,0,7,2000,Summer,927,0.007551241
Belarus,BLR,3,3,11,17,2000,Summer,927,0.018338727
Canada,CAN,3,3,8,14,2000,Summer,927,0.015102481
Spain,ESP,3,3,5,11,2000,Summer,927,0.011866235
Türkiye,TUR,3,0,2,5,2000,Summer,927,0.005393743
Islamic Republic of Iran,IRI,3,0,1,4,2000,Summer,927,0.004314995
Czechia,CZE,2,3,3,8,2000,Summer,927,0.008629989
Kenya,KEN,2,3,2,7,2000,Summer,927,0.007551241
Denmark,DEN,2,3,1,6,2000,Summer,927,0.006472492
Finland,FIN,2,1,1,4,2000,Summer,927,0.004314995
Austria,AUT,2,1,0,3,2000,Summer,927,0.003236246
Lithuania,LTU,2,0,3,5,2000,Summer,927,0.005393743
Azerbaijan,AZE,2,0,1,3,2000,Summer,927,0.003236246
The Bahamas,BAH,2,0,1,3,2000,Summer,927,0.003236246
Slovenia,SLO,2,0,0,2,2000,Summer,927,0.002157497
Switzerland,SUI,1,6,2,9,2000,Summer,927,0.009708738
Indonesia,INA,1,3,2,6,2000,Summer,927,0.006472492
Slovakia,SVK,1,3,1,5,2000,Summer,927,0.005393743
Mexico,MEX,1,2,3,6,2000,Summer,927,0.006472492
Nigeria,NGR,1,2,0,3,2000,Summer,927,0.003236246
Algeria,ALG,1,1,3,5,2000,Summer,927,0.005393743
Uzbekistan,UZB,1,1,2,4,2000,Summer,927,0.004314995
Latvia,LAT,1,1,1,3,2000,Summer,927,0.003236246
Serbia and Montenegro,SCG,1,1,1,3,2000,Summer,927,0.003236246
New Zealand,NZL,1,0,3,4,2000,Summer,927,0.004314995
Estonia,EST,1,0,2,3,2000,Summer,927,0.003236246
Thailand,THA,1,0,2,3,2000,Summer,927,0.003236246
Croatia,CRO,1,0,1,2,2000,Summer,927,0.002157497
Cameroon,CMR,1,0,0,1,2000,Summer,927,0.001078749
Colombia,COL,1,0,0,1,2000,Summer,927,0.001078749
Mozambique,MOZ,1,0,0,1,2000,Summer,927,0.001078749
Brazil,BRA,0,6,6,12,2000,Summer,927,0.012944984
Jamaica,JAM,0,6,3,9,2000,Summer,927,0.009708738
Belgium,BEL,0,2,3,5,2000,Summer,927,0.005393743
South Africa,RSA,0,2,3,5,2000,Summer,927,0.005393743
Argentina,ARG,0,2,2,4,2000,Summer,927,0.004314995
Chinese Taipei,TPE,0,1,4,5,2000,Summer,927,0.005393743
Morocco,MAR,0,1,4,5,2000,Summer,927,0.005393743
Democratic People's Republic of Korea,PRK,0,1,3,4,2000,Summer,927,0.004314995
Kingdom of Saudi Arabia,KSA,0,1,1,2,2000,Summer,927,0.002157497
Republic of Moldova,MDA,0,1,1,2,2000,Summer,927,0.002157497
Trinidad and Tobago,TTO,0,1,1,2,2000,Summer,927,0.002157497
Ireland,IRL,0,1,0,1,2000,Summer,927,0.001078749
Sri Lanka,SRI,0,1,0,1,2000,Summer,927,0.001078749
Uruguay,URU,0,1,0,1,2000,Summer,927,0.001078749
Vietnam,VIE,0,1,0,1,2000,Summer,927,0.001078749
Georgia,GEO,0,0,6,6,2000,Summer,927,0.006472492
Costa Rica,CRC,0,0,2,2,2000,Summer,927,0.002157497
Portugal,POR,0,0,2,2,2000,Summer,927,0.002157497
Armenia,ARM,0,0,1,1,2000,Summer,927,0.001078749
Barbados,BAR,0,0,1,1,2000,Summer,927,0.001078749
Chile,CHI,0,0,1,1,2000,Summer,927,0.001078749
Iceland,ISL,0,0,1,1,2000,Summer,927,0.001078749
India,IND,0,0,1,1,2000,Summer,927,0.001078749
Israel,ISR,0,0,1,1,2000,Summer,927,0.001078749
Kuwait,KUW,0,0,1,1,2000,Summer,927,0.001078749
Kyrgyzstan,KGZ,0,0,1,1,2000,Summer,927,0.001078749
North Macedonia,MKD,0,0,1,1,2000,Summer,927,0.001078749
Qatar,QAT,0,0,1,1,2000,Summer,927,0.001078749
United States,USA,36,39,26,101,2004,Summer,926,0.109071274
People's Republic of China,CHN,32,17,14,63,2004,Summer,926,0.068034557
Russian Federation,RUS,28,26,36,90,2004,Summer,926,0.097192225
Australia,AUS,17,16,17,50,2004,Summer,926,0.05399568
Japan,JPN,16,9,12,37,2004,Summer,926,0.039956803
Germany,GER,13,16,20,49,2004,Summer,926,0.052915767
France,FRA,11,9,13,33,2004,Summer,926,0.035637149
Italy,ITA,10,11,11,32,2004,Summer,926,0.034557235
Republic of Korea,KOR,9,12,9,30,2004,Summer,926,0.032397408
Great Britain,GBR,9,9,12,30,2004,Summer,926,0.032397408
Cuba,CUB,9,7,11,27,2004,Summer,926,0.029157667
Hungary,HUN,8,6,3,17,2004,Summer,926,0.018358531
Ukraine,UKR,8,5,9,22,2004,Summer,926,0.023758099
Romania,ROU,8,5,6,19,2004,Summer,926,0.020518359
Greece,GRE,6,6,4,16,2004,Summer,926,0.017278618
Brazil,BRA,5,2,3,10,2004,Summer,926,0.010799136
Norway,NOR,5,0,1,6,2004,Summer,926,0.006479482
Netherlands,NED,4,9,9,22,2004,Summer,926,0.023758099
Sweden,SWE,4,2,1,7,2004,Summer,926,0.007559395
Spain,ESP,3,11,6,20,2004,Summer,926,0.021598272
Canada,CAN,3,6,3,12,2004,Summer,926,0.012958963
Türkiye,TUR,3,3,4,10,2004,Summer,926,0.010799136
Poland,POL,3,2,5,10,2004,Summer,926,0.010799136
New Zealand,NZL,3,2,0,5,2004,Summer,926,0.005399568
Thailand,THA,3,1,4,8,2004,Summer,926,0.008639309
Belarus,BLR,2,5,6,13,2004,Summer,926,0.014038877
Austria,AUT,2,4,1,7,2004,Summer,926,0.007559395
Ethiopia,ETH,2,3,2,7,2004,Summer,926,0.007559395
Islamic Republic of Iran,IRI,2,2,2,6,2004,Summer,926,0.006479482
Slovakia,SVK,2,2,2,6,2004,Summer,926,0.006479482
Chinese Taipei,TPE,2,2,1,5,2004,Summer,926,0.005399568
Georgia,GEO,2,2,0,4,2004,Summer,926,0.004319654
Bulgaria,BUL,2,1,9,12,2004,Summer,926,0.012958963
Denmark,DEN,2,1,5,8,2004,Summer,926,0.008639309
Jamaica,JAM,2,1,2,5,2004,Summer,926,0.005399568
Uzbekistan,UZB,2,1,2,5,2004,Summer,926,0.005399568
Morocco,MAR,2,1,0,3,2004,Summer,926,0.003239741
Argentina,ARG,2,0,4,6,2004,Summer,926,0.006479482
Chile,CHI,2,0,1,3,2004,Summer,926,0.003239741
Kazakhstan,KAZ,1,4,3,8,2004,Summer,926,0.008639309
Kenya,KEN,1,4,2,7,2004,Summer,926,0.007559395
Czechia,CZE,1,3,5,9,2004,Summer,926,0.009719222
South Africa,RSA,1,3,2,6,2004,Summer,926,0.006479482
Croatia,CRO,1,2,2,5,2004,Summer,926,0.005399568
Lithuania,LTU,1,2,0,3,2004,Summer,926,0.003239741
Egypt,EGY,1,1,3,5,2004,Summer,926,0.005399568
Switzerland,SUI,1,1,3,5,2004,Summer,926,0.005399568
Indonesia,INA,1,1,2,4,2004,Summer,926,0.004319654
Zimbabwe,ZIM,1,1,1,3,2004,Summer,926,0.003239741
Azerbaijan,AZE,1,0,4,5,2004,Summer,926,0.005399568
Belgium,BEL,1,0,2,3,2004,Summer,926,0.003239741
Israel,ISR,1,0,1,2,2004,Summer,926,0.002159827
The Bahamas,BAH,1,0,1,2,2004,Summer,926,0.002159827
Cameroon,CMR,1,0,0,1,2004,Summer,926,0.001079914
Dominican Republic,DOM,1,0,0,1,2004,Summer,926,0.001079914
United Arab Emirates,UAE,1,0,0,1,2004,Summer,926,0.001079914
Democratic People's Republic of Korea,PRK,0,4,1,5,2004,Summer,926,0.005399568
Latvia,LAT,0,4,0,4,2004,Summer,926,0.004319654
Mexico,MEX,0,3,1,4,2004,Summer,926,0.004319654
Portugal,POR,0,2,1,3,2004,Summer,926,0.003239741
Finland,FIN,0,2,0,2,2004,Summer,926,0.002159827
Serbia and Montenegro,SCG,0,2,0,2,2004,Summer,926,0.002159827
Slovenia,SLO,0,1,3,4,2004,Summer,926,0.004319654
Estonia,EST,0,1,2,3,2004,Summer,926,0.003239741
"Hong Kong, China",HKG,0,1,0,1,2004,Summer,926,0.001079914
India,IND,0,1,0,1,2004,Summer,926,0.001079914
Paraguay,PAR,0,1,0,1,2004,Summer,926,0.001079914
Colombia,COL,0,0,2,2,2004,Summer,926,0.002159827
Nigeria,NGR,0,0,2,2,2004,Summer,926,0.002159827
Venezuela,VEN,0,0,2,2,2004,Summer,926,0.002159827
Eritrea,ERI,0,0,1,1,2004,Summer,926,0.001079914
Mongolia,MGL,0,0,1,1,2004,Summer,926,0.001079914
Syrian Arab Republic,SYR,0,0,1,1,2004,Summer,926,0.001079914
Trinidad and Tobago,TTO,0,0,1,1,2004,Summer,926,0.001079914
People's Republic of China,CHN,48,22,30,100,2008,Summer,958,0.104384134
United States,USA,36,39,37,112,2008,Summer,958,0.11691023
Russian Federation,RUS,24,13,23,60,2008,Summer,958,0.06263048
Great Britain,GBR,19,13,19,51,2008,Summer,958,0.053235908
Germany,GER,16,11,14,41,2008,Summer,958,0.042797495
Australia,AUS,14,15,17,46,2008,Summer,958,0.048016701
Republic of Korea,KOR,13,11,8,32,2008,Summer,958,0.033402923
Japan,JPN,9,8,8,25,2008,Summer,958,0.026096033
Italy,ITA,8,9,10,27,2008,Summer,958,0.028183716
France,FRA,7,16,20,43,2008,Summer,958,0.044885177
Netherlands,NED,7,5,4,16,2008,Summer,958,0.016701461
Ukraine,UKR,7,4,11,22,2008,Summer,958,0.022964509
Kenya,KEN,6,4,6,16,2008,Summer,958,0.016701461
Spain,ESP,5,11,3,19,2008,Summer,958,0.019832985
Jamaica,JAM,5,4,2,11,2008,Summer,958,0.011482255
Poland,POL,4,5,2,11,2008,Summer,958,0.011482255
Ethiopia,ETH,4,2,1,7,2008,Summer,958,0.007306889
Romania,ROU,4,1,4,9,2008,Summer,958,0.009394572
Cuba,CUB,3,10,17,30,2008,Summer,958,0.03131524
Canada,CAN,3,9,8,20,2008,Summer,958,0.020876827
Hungary,HUN,3,5,2,10,2008,Summer,958,0.010438413
Norway,NOR,3,5,1,9,2008,Summer,958,0.009394572
Brazil,BRA,3,4,10,17,2008,Summer,958,0.017745303
Belarus,BLR,3,4,7,14,2008,Summer,958,0.014613779
Czechia,CZE,3,3,1,7,2008,Summer,958,0.007306889
Slovakia,SVK,3,3,0,6,2008,Summer,958,0.006263048
New Zealand,NZL,3,2,4,9,2008,Summer,958,0.009394572
Georgia,GEO,3,2,2,7,2008,Summer,958,0.007306889
Kazakhstan,KAZ,2,3,4,9,2008,Summer,958,0.009394572
Denmark,DEN,2,2,3,7,2008,Summer,958,0.007306889
Democratic People's Republic of Korea,PRK,2,2,2,6,2008,Summer,958,0.006263048
Thailand,THA,2,2,2,6,2008,Summer,958,0.006263048
Mongolia,MGL,2,2,0,4,2008,Summer,958,0.004175365
Switzerland,SUI,2,1,4,7,2008,Summer,958,0.007306889
Argentina,ARG,2,0,4,6,2008,Summer,958,0.006263048
Mexico,MEX,2,0,2,4,2008,Summer,958,0.004175365
Belgium,BEL,2,0,0,2,2008,Summer,958,0.002087683
Zimbabwe,ZIM,1,3,0,4,2008,Summer,958,0.004175365
Slovenia,SLO,1,2,2,5,2008,Summer,958,0.005219207
Azerbaijan,AZE,1,1,4,6,2008,Summer,958,0.006263048
Indonesia,INA,1,1,4,6,2008,Summer,958,0.006263048
Bulgaria,BUL,1,1,3,5,2008,Summer,958,0.005219207
Türkiye,TUR,1,1,3,5,2008,Summer,958,0.005219207
Chinese Taipei,TPE,1,1,2,4,2008,Summer,958,0.004175365
Finland,FIN,1,1,2,4,2008,Summer,958,0.004175365
Latvia,LAT,1,1,1,3,2008,Summer,958,0.003131524
Dominican Republic,DOM,1,1,0,2,2008,Summer,958,0.002087683
Estonia,EST,1,1,0,2,2008,Summer,958,0.002087683
Portugal,POR,1,1,0,2,2008,Summer,958,0.002087683
Trinidad and Tobago,TTO,1,1,0,2,2008,Summer,958,0.002087683
India,IND,1,0,2,3,2008,Summer,958,0.003131524
Islamic Republic of Iran,IRI,1,0,1,2,2008,Summer,958,0.002087683
Cameroon,CMR,1,0,0,1,2008,Summer,958,0.001043841
Panama,PAN,1,0,0,1,2008,Summer,958,0.001043841
Tunisia,TUN,1,0,0,1,2008,Summer,958,0.001043841
Sweden,SWE,0,4,1,5,2008,Summer,958,0.005219207
Lithuania,LTU,0,3,2,5,2008,Summer,958,0.005219207
Nigeria,NGR,0,3,2,5,2008,Summer,958,0.005219207
Croatia,CRO,0,2,3,5,2008,Summer,958,0.005219207
Colombia,COL,0,2,1,3,2008,Summer,958,0.003131524
Greece,GRE,0,2,1,3,2008,Summer,958,0.003131524
Armenia,ARM,0,1,4,5,2008,Summer,958,0.005219207
Uzbekistan,UZB,0,1,3,4,2008,Summer,958,0.004175365
Austria,AUT,0,1,2,3,2008,Summer,958,0.003131524
Ireland,IRL,0,1,2,3,2008,Summer,958,0.003131524
Kyrgyzstan,KGZ,0,1,2,3,2008,Summer,958,0.003131524
Serbia,SRB,0,1,2,3,2008,Summer,958,0.003131524
Algeria,ALG,0,1,1,2,2008,Summer,958,0.002087683
Morocco,MAR,0,1,1,2,2008,Summer,958,0.002087683
Tajikistan,TJK,0,1,1,2,2008,Summer,958,0.002087683
The Bahamas,BAH,0,1,1,2,2008,Summer,958,0.002087683
Chile,CHI,0,1,0,1,2008,Summer,958,0.001043841
Ecuador,ECU,0,1,0,1,2008,Summer,958,0.001043841
Iceland,ISL,0,1,0,1,2008,Summer,958,0.001043841
Malaysia,MAS,0,1,0,1,2008,Summer,958,0.001043841
Samoa,SAM,0,1,0,1,2008,Summer,958,0.001043841
Singapore,SGP,0,1,0,1,2008,Summer,958,0.001043841
South Africa,RSA,0,1,0,1,2008,Summer,958,0.001043841
Sudan,SUD,0,1,0,1,2008,Summer,958,0.001043841
Vietnam,VIE,0,1,0,1,2008,Summer,958,0.001043841
Egypt,EGY,0,0,2,2,2008,Summer,958,0.002087683
Afghanistan,AFG,0,0,1,1,2008,Summer,958,0.001043841
Israel,ISR,0,0,1,1,2008,Summer,958,0.001043841
Mauritius,MRI,0,0,1,1,2008,Summer,958,0.001043841
Republic of Moldova,MDA,0,0,1,1,2008,Summer,958,0.001043841
Togo,TOG,0,0,1,1,2008,Summer,958,0.001043841
Venezuela,VEN,0,0,1,1,2008,Summer,958,0.001043841
United States,USA,48,26,30,104,2012,Summer,960,0.108333333
People's Republic of China,CHN,39,31,22,92,2012,Summer,960,0.095833333
Great Britain,GBR,29,18,18,65,2012,Summer,960,0.067708333
Russian Federation,RUS,18,21,26,65,2012,Summer,960,0.067708333
Republic of Korea,KOR,13,9,8,30,2012,Summer,960,0.03125
Germany,GER,11,20,13,44,2012,Summer,960,0.045833333
France,FRA,11,11,13,35,2012,Summer,960,0.036458333
Australia,AUS,8,15,12,35,2012,Summer,960,0.036458333
Italy,ITA,8,9,11,28,2012,Summer,960,0.029166667
Hungary,HUN,8,4,6,18,2012,Summer,960,0.01875
Japan,JPN,7,14,17,38,2012,Summer,960,0.039583333
Islamic Republic of Iran,IRI,7,5,1,13,2012,Summer,960,0.013541667
Netherlands,NED,6,6,8,20,2012,Summer,960,0.020833333
New Zealand,NZL,6,2,5,13,2012,Summer,960,0.013541667
Ukraine,UKR,5,4,10,19,2012,Summer,960,0.019791667
Cuba,CUB,5,3,7,15,2012,Summer,960,0.015625
Spain,ESP,4,10,6,20,2012,Summer,960,0.020833333
Jamaica,JAM,4,5,4,13,2012,Summer,960,0.013541667
Czechia,CZE,4,4,3,11,2012,Summer,960,0.011458333
South Africa,RSA,4,1,1,6,2012,Summer,960,0.00625
Democratic People's Republic of Korea,PRK,4,0,3,7,2012,Summer,960,0.007291667
Brazil,BRA,3,5,9,17,2012,Summer,960,0.017708333
Poland,POL,3,2,6,11,2012,Summer,960,0.011458333
Ethiopia,ETH,3,2,3,8,2012,Summer,960,0.008333333
Kazakhstan,KAZ,3,1,7,11,2012,Summer,960,0.011458333
Croatia,CRO,3,1,2,6,2012,Summer,960,0.00625
Canada,CAN,2,6,10,18,2012,Summer,960,0.01875
Belarus,BLR,2,5,3,10,2012,Summer,960,0.010416667
Kenya,KEN,2,4,7,13,2012,Summer,960,0.013541667
Denmark,DEN,2,4,3,9,2012,Summer,960,0.009375
Romania,ROU,2,4,1,7,2012,Summer,960,0.007291667
Azerbaijan,AZE,2,2,5,9,2012,Summer,960,0.009375
Switzerland,SUI,2,2,0,4,2012,Summer,960,0.004166667
Norway,NOR,2,1,1,4,2012,Summer,960,0.004166667
Lithuania,LTU,2,0,3,5,2012,Summer,960,0.005208333
Tunisia,TUN,2,0,1,3,2012,Summer,960,0.003125
Sweden,SWE,1,4,3,8,2012,Summer,960,0.008333333
Colombia,COL,1,3,5,9,2012,Summer,960,0.009375
Mexico,MEX,1,3,4,8,2012,Summer,960,0.008333333
Georgia,GEO,1,2,3,6,2012,Summer,960,0.00625
Ireland,IRL,1,1,4,6,2012,Summer,960,0.00625
Argentina,ARG,1,1,2,4,2012,Summer,960,0.004166667
Serbia,SRB,1,1,2,4,2012,Summer,960,0.004166667
Slovenia,SLO,1,1,2,4,2012,Summer,960,0.004166667
Trinidad and Tobago,TTO,1,1,2,4,2012,Summer,960,0.004166667
Türkiye,TUR,1,1,1,3,2012,Summer,960,0.003125
Dominican Republic,DOM,1,1,0,2,2012,Summer,960,0.002083333
Chinese Taipei,TPE,1,0,1,2,2012,Summer,960,0.002083333
Latvia,LAT,1,0,1,2,2012,Summer,960,0.002083333
Algeria,ALG,1,0,0,1,2012,Summer,960,0.001041667
Bahrain,BRN,1,0,0,1,2012,Summer,960,0.001041667
Grenada,GRN,1,0,0,1,2012,Summer,960,0.001041667
The Bahamas,BAH,1,0,0,1,2012,Summer,960,0.001041667
Uganda,UGA,1,0,0,1,2012,Summer,960,0.001041667
Venezuela,VEN,1,0,0,1,2012,Summer,960,0.001041667
Egypt,EGY,0,3,1,4,2012,Summer,960,0.004166667
India,IND,0,2,4,6,2012,Summer,960,0.00625
Mongolia,MGL,0,2,3,5,2012,Summer,960,0.005208333
Thailand,THA,0,2,2,4,2012,Summer,960,0.004166667
Bulgaria,BUL,0,2,1,3,2012,Summer,960,0.003125
Finland,FIN,0,2,1,3,2012,Summer,960,0.003125
Indonesia,INA,0,2,1,3,2012,Summer,960,0.003125
Slovakia,SVK,0,1,3,4,2012,Summer,960,0.004166667
Belgium,BEL,0,1,2,3,2012,Summer,960,0.003125
Armenia,ARM,0,1,1,2,2012,Summer,960,0.002083333
Estonia,EST,0,1,1,2,2012,Summer,960,0.002083333
Malaysia,MAS,0,1,1,2,2012,Summer,960,0.002083333
Puerto Rico,PUR,0,1,1,2,2012,Summer,960,0.002083333
Qatar,QAT,0,1,1,2,2012,Summer,960,0.002083333
Botswana,BOT,0,1,0,1,2012,Summer,960,0.001041667
Cyprus,CYP,0,1,0,1,2012,Summer,960,0.001041667
Gabon,GAB,0,1,0,1,2012,Summer,960,0.001041667
Guatemala,GUA,0,1,0,1,2012,Summer,960,0.001041667
Montenegro,MNE,0,1,0,1,2012,Summer,960,0.001041667
Portugal,POR,0,1,0,1,2012,Summer,960,0.001041667
Uzbekistan,UZB,0,0,3,3,2012,Summer,960,0.003125
Greece,GRE,0,0,2,2,2012,Summer,960,0.002083333
Singapore,SGP,0,0,2,2,2012,Summer,960,0.002083333
Afghanistan,AFG,0,0,1,1,2012,Summer,960,0.001041667
Cameroon,CMR,0,0,1,1,2012,Summer,960,0.001041667
"Hong Kong, China",HKG,0,0,1,1,2012,Summer,960,0.001041667
Kingdom of Saudi Arabia,KSA,0,0,1,1,2012,Summer,960,0.001041667
Kuwait,KUW,0,0,1,1,2012,Summer,960,0.001041667
Morocco,MAR,0,0,1,1,2012,Summer,960,0.001041667
Tajikistan,TJK,0,0,1,1,2012,Summer,960,0.001041667
Vietnam,VIE,0,0,1,1,2012,Summer,960,0.001041667
United States,USA,46,37,38,121,2016,Summer,972,0.124485597
Great Britain,GBR,27,23,17,67,2016,Summer,972,0.068930041
People's Republic of China,CHN,26,18,26,70,2016,Summer,972,0.072016461
Russian Federation,RUS,19,17,20,56,2016,Summer,972,0.057613169
Germany,GER,17,10,15,42,2016,Summer,972,0.043209877
Japan,JPN,12,8,21,41,2016,Summer,972,0.04218107
France,FRA,10,18,14,42,2016,Summer,972,0.043209877
Republic of Korea,KOR,9,3,9,21,2016,Summer,972,0.021604938
Italy,ITA,8,12,8,28,2016,Summer,972,0.028806584
Australia,AUS,8,11,10,29,2016,Summer,972,0.029835391
Netherlands,NED,8,7,4,19,2016,Summer,972,0.019547325
Hungary,HUN,8,3,4,15,2016,Summer,972,0.015432099
Brazil,BRA,7,6,6,19,2016,Summer,972,0.019547325
Spain,ESP,7,4,6,17,2016,Summer,972,0.017489712
Kenya,KEN,6,6,1,13,2016,Summer,972,0.013374486
Jamaica,JAM,6,3,2,11,2016,Summer,972,0.011316872
Croatia,CRO,5,3,2,10,2016,Summer,972,0.010288066
Cuba,CUB,5,2,4,11,2016,Summer,972,0.011316872
New Zealand,NZL,4,9,5,18,2016,Summer,972,0.018518519
Canada,CAN,4,3,15,22,2016,Summer,972,0.022633745
Uzbekistan,UZB,4,2,7,13,2016,Summer,972,0.013374486
Colombia,COL,3,2,3,8,2016,Summer,972,0.008230453
Switzerland,SUI,3,2,2,7,2016,Summer,972,0.007201646
Islamic Republic of Iran,IRI,3,1,4,8,2016,Summer,972,0.008230453
Greece,GRE,3,1,2,6,2016,Summer,972,0.00617284
Argentina,ARG,3,1,0,4,2016,Summer,972,0.004115226
Denmark,DEN,2,6,7,15,2016,Summer,972,0.015432099
Sweden,SWE,2,6,3,11,2016,Summer,972,0.011316872
South Africa,RSA,2,6,2,10,2016,Summer,972,0.010288066
Kazakhstan,KAZ,2,5,10,17,2016,Summer,972,0.017489712
Ukraine,UKR,2,5,4,11,2016,Summer,972,0.011316872
Serbia,SRB,2,4,2,8,2016,Summer,972,0.008230453
Poland,POL,2,3,6,11,2016,Summer,972,0.011316872
Democratic People's Republic of Korea,PRK,2,3,2,7,2016,Summer,972,0.007201646
Belgium,BEL,2,2,2,6,2016,Summer,972,0.00617284
Thailand,THA,2,2,2,6,2016,Summer,972,0.00617284
Slovakia,SVK,2,2,0,4,2016,Summer,972,0.004115226
Georgia,GEO,2,1,4,7,2016,Summer,972,0.007201646
Azerbaijan,AZE,1,7,10,18,2016,Summer,972,0.018518519
Belarus,BLR,1,4,4,9,2016,Summer,972,0.009259259
Türkiye,TUR,1,3,4,8,2016,Summer,972,0.008230453
Armenia,ARM,1,3,0,4,2016,Summer,972,0.004115226
Czechia,CZE,1,2,7,10,2016,Summer,972,0.010288066
Ethiopia,ETH,1,2,5,8,2016,Summer,972,0.008230453
Slovenia,SLO,1,2,1,4,2016,Summer,972,0.004115226
Indonesia,INA,1,2,0,3,2016,Summer,972,0.00308642
Romania,ROU,1,1,2,4,2016,Summer,972,0.004115226
Bahrain,BRN,1,1,0,2,2016,Summer,972,0.002057613
Vietnam,VIE,1,1,0,2,2016,Summer,972,0.002057613
Chinese Taipei,TPE,1,0,2,3,2016,Summer,972,0.00308642
Côte d'Ivoire,CIV,1,0,1,2,2016,Summer,972,0.002057613
Independent Olympic Athletes,IOA,1,0,1,2,2016,Summer,972,0.002057613
The Bahamas,BAH,1,0,1,2,2016,Summer,972,0.002057613
Fiji,FIJ,1,0,0,1,2016,Summer,972,0.001028807
Jordan,JOR,1,0,0,1,2016,Summer,972,0.001028807
Kosovo,KOS,1,0,0,1,2016,Summer,972,0.001028807
Puerto Rico,PUR,1,0,0,1,2016,Summer,972,0.001028807
Singapore,SGP,1,0,0,1,2016,Summer,972,0.001028807
Tajikistan,TJK,1,0,0,1,2016,Summer,972,0.001028807
Malaysia,MAS,0,4,1,5,2016,Summer,972,0.005144033
Mexico,MEX,0,3,2,5,2016,Summer,972,0.005144033
Venezuela,VEN,0,2,1,3,2016,Summer,972,0.00308642
Algeria,ALG,0,2,0,2,2016,Summer,972,0.002057613
Ireland,IRL,0,2,0,2,2016,Summer,972,0.002057613
Lithuania,LTU,0,1,3,4,2016,Summer,972,0.004115226
Bulgaria,BUL,0,1,2,3,2016,Summer,972,0.00308642
India,IND,0,1,1,2,2016,Summer,972,0.002057613
Mongolia,MGL,0,1,1,2,2016,Summer,972,0.002057613
Burundi,BDI,0,1,0,1,2016,Summer,972,0.001028807
Grenada,GRN,0,1,0,1,2016,Summer,972,0.001028807
Niger,NIG,0,1,0,1,2016,Summer,972,0.001028807
Philippines,PHI,0,1,0,1,2016,Summer,972,0.001028807
Qatar,QAT,0,1,0,1,2016,Summer,972,0.001028807
Norway,NOR,0,0,4,4,2016,Summer,972,0.004115226
Egypt,EGY,0,0,3,3,2016,Summer,972,0.00308642
Tunisia,TUN,0,0,3,3,2016,Summer,972,0.00308642
Israel,ISR,0,0,2,2,2016,Summer,972,0.002057613
Austria,AUT,0,0,1,1,2016,Summer,972,0.001028807
Dominican Republic,DOM,0,0,1,1,2016,Summer,972,0.001028807
Estonia,EST,0,0,1,1,2016,Summer,972,0.001028807
Finland,FIN,0,0,1,1,2016,Summer,972,0.001028807
Morocco,MAR,0,0,1,1,2016,Summer,972,0.001028807
Nigeria,NGR,0,0,1,1,2016,Summer,972,0.001028807
Portugal,POR,0,0,1,1,2016,Summer,972,0.001028807
Trinidad and Tobago,TTO,0,0,1,1,2016,Summer,972,0.001028807
United Arab Emirates,UAE,0,0,1,1,2016,Summer,972,0.001028807
United States,USA,39,41,33,113,2020,Summer,1080,0.10462963
People's Republic of China,CHN,38,32,19,89,2020,Summer,1080,0.082407407
Japan,JPN,27,14,17,58,2020,Summer,1080,0.053703704
Great Britain,GBR,22,20,22,64,2020,Summer,1080,0.059259259
ROC,ROC,20,28,23,71,2020,Summer,1080,0.065740741
Australia,AUS,17,7,22,46,2020,Summer,1080,0.042592593
Netherlands,NED,10,12,14,36,2020,Summer,1080,0.033333333
France,FRA,10,12,11,33,2020,Summer,1080,0.030555556
Germany,GER,10,11,16,37,2020,Summer,1080,0.034259259
Italy,ITA,10,10,20,40,2020,Summer,1080,0.037037037
Canada,CAN,7,7,10,24,2020,Summer,1080,0.022222222
Brazil,BRA,7,6,8,21,2020,Summer,1080,0.019444444
New Zealand,NZL,7,6,7,20,2020,Summer,1080,0.018518519
Cuba,CUB,7,3,5,15,2020,Summer,1080,0.013888889
Hungary,HUN,6,7,7,20,2020,Summer,1080,0.018518519
Republic of Korea,KOR,6,4,10,20,2020,Summer,1080,0.018518519
Poland,POL,4,5,5,14,2020,Summer,1080,0.012962963
Czechia,CZE,4,4,3,11,2020,Summer,1080,0.010185185
Kenya,KEN,4,4,2,10,2020,Summer,1080,0.009259259
Norway,NOR,4,2,2,8,2020,Summer,1080,0.007407407
Jamaica,JAM,4,1,4,9,2020,Summer,1080,0.008333333
Spain,ESP,3,8,6,17,2020,Summer,1080,0.015740741
Sweden,SWE,3,6,0,9,2020,Summer,1080,0.008333333
Switzerland,SUI,3,4,6,13,2020,Summer,1080,0.012037037
Denmark,DEN,3,4,4,11,2020,Summer,1080,0.010185185
Croatia,CRO,3,3,2,8,2020,Summer,1080,0.007407407
Islamic Republic of Iran,IRI,3,2,2,7,2020,Summer,1080,0.006481481
Serbia,SRB,3,1,5,9,2020,Summer,1080,0.008333333
Belgium,BEL,3,1,3,7,2020,Summer,1080,0.006481481
Bulgaria,BUL,3,1,2,6,2020,Summer,1080,0.005555556
Slovenia,SLO,3,1,1,5,2020,Summer,1080,0.00462963
Uzbekistan,UZB,3,0,2,5,2020,Summer,1080,0.00462963
Georgia,GEO,2,5,1,8,2020,Summer,1080,0.007407407
Chinese Taipei,TPE,2,4,6,12,2020,Summer,1080,0.011111111
Türkiye,TUR,2,2,9,13,2020,Summer,1080,0.012037037
Greece,GRE,2,1,1,4,2020,Summer,1080,0.003703704
Uganda,UGA,2,1,1,4,2020,Summer,1080,0.003703704
Ecuador,ECU,2,1,0,3,2020,Summer,1080,0.002777778
Ireland,IRL,2,0,2,4,2020,Summer,1080,0.003703704
Israel,ISR,2,0,2,4,2020,Summer,1080,0.003703704
Qatar,QAT,2,0,1,3,2020,Summer,1080,0.002777778
Kosovo,KOS,2,0,0,2,2020,Summer,1080,0.001851852
The Bahamas,BAH,2,0,0,2,2020,Summer,1080,0.001851852
Ukraine,UKR,1,6,12,19,2020,Summer,1080,0.017592593
Belarus,BLR,1,3,3,7,2020,Summer,1080,0.006481481
Romania,ROU,1,3,0,4,2020,Summer,1080,0.003703704
Venezuela,VEN,1,3,0,4,2020,Summer,1080,0.003703704
India,IND,1,2,4,7,2020,Summer,1080,0.006481481
"Hong Kong, China",HKG,1,2,3,6,2020,Summer,1080,0.005555556
Philippines,PHI,1,2,1,4,2020,Summer,1080,0.003703704
Slovakia,SVK,1,2,1,4,2020,Summer,1080,0.003703704
South Africa,RSA,1,2,0,3,2020,Summer,1080,0.002777778
Austria,AUT,1,1,5,7,2020,Summer,1080,0.006481481
Egypt,EGY,1,1,4,6,2020,Summer,1080,0.005555556
Indonesia,INA,1,1,3,5,2020,Summer,1080,0.00462963
Ethiopia,ETH,1,1,2,4,2020,Summer,1080,0.003703704
Portugal,POR,1,1,2,4,2020,Summer,1080,0.003703704
Tunisia,TUN,1,1,0,2,2020,Summer,1080,0.001851852
Estonia,EST,1,0,1,2,2020,Summer,1080,0.001851852
Fiji,FIJ,1,0,1,2,2020,Summer,1080,0.001851852
Latvia,LAT,1,0,1,2,2020,Summer,1080,0.001851852
Thailand,THA,1,0,1,2,2020,Summer,1080,0.001851852
Bermuda,BER,1,0,0,1,2020,Summer,1080,0.000925926
Morocco,MAR,1,0,0,1,2020,Summer,1080,0.000925926
Puerto Rico,PUR,1,0,0,1,2020,Summer,1080,0.000925926
Colombia,COL,0,4,1,5,2020,Summer,1080,0.00462963
Azerbaijan,AZE,0,3,4,7,2020,Summer,1080,0.006481481
Dominican Republic,DOM,0,3,2,5,2020,Summer,1080,0.00462963
Armenia,ARM,0,2,2,4,2020,Summer,1080,0.003703704
Kyrgyzstan,KGZ,0,2,1,3,2020,Summer,1080,0.002777778
Mongolia,MGL,0,1,3,4,2020,Summer,1080,0.003703704
Argentina,ARG,0,1,2,3,2020,Summer,1080,0.002777778
San Marino,SMR,0,1,2,3,2020,Summer,1080,0.002777778
Jordan,JOR,0,1,1,2,2020,Summer,1080,0.001851852
Malaysia,MAS,0,1,1,2,2020,Summer,1080,0.001851852
Nigeria,NGR,0,1,1,2,2020,Summer,1080,0.001851852
Bahrain,BRN,0,1,0,1,2020,Summer,1080,0.000925926
Kingdom of Saudi Arabia,KSA,0,1,0,1,2020,Summer,1080,0.000925926
Lithuania,LTU,0,1,0,1,2020,Summer,1080,0.000925926
Namibia,NAM,0,1,0,1,2020,Summer,1080,0.000925926
North Macedonia,MKD,0,1,0,1,2020,Summer,1080,0.000925926
Turkmenistan,TKM,0,1,0,1,2020,Summer,1080,0.000925926
Kazakhstan,KAZ,0,0,8,8,2020,Summer,1080,0.007407407
Mexico,MEX,0,0,4,4,2020,Summer,1080,0.003703704
Finland,FIN,0,0,2,2,2020,Summer,1080,0.001851852
Botswana,BOT,0,0,1,1,2020,Summer,1080,0.000925926
Burkina Faso,BUR,0,0,1,1,2020,Summer,1080,0.000925926
Côte d'Ivoire,CIV,0,0,1,1,2020,Summer,1080,0.000925926
Ghana,GHA,0,0,1,1,2020,Summer,1080,0.000925926
Grenada,GRN,0,0,1,1,2020,Summer,1080,0.000925926
Kuwait,KUW,0,0,1,1,2020,Summer,1080,0.000925926
Republic of Moldova,MDA,0,0,1,1,2020,Summer,1080,0.000925926
Syrian Arab Republic,SYR,0,0,1,1,2020,Summer,1080,0.000925926
Norway,NOR,4,7,6,17,1924,Winter,50,0.34
Finland,FIN,4,4,3,11,1924,Winter,50,0.22
Austria,AUT,2,1,0,3,1924,Winter,50,0.06
Switzerland,SUI,2,0,1,3,1924,Winter,50,0.06
United States,USA,1,2,1,4,1924,Winter,50,0.08
Great Britain,GBR,1,1,2,4,1924,Winter,50,0.08
Sweden,SWE,1,1,0,2,1924,Winter,50,0.04
Canada,CAN,1,0,0,1,1924,Winter,50,0.02
Mixed team,MIX,1,0,0,1,1924,Winter,50,0.02
France,FRA,0,0,3,3,1924,Winter,50,0.06
Belgium,BEL,0,0,1,1,1924,Winter,50,0.02
Norway,NOR,6,4,5,15,1928,Winter,41,0.365853659
United States,USA,2,2,2,6,1928,Winter,41,0.146341463
Sweden,SWE,2,2,1,5,1928,Winter,41,0.12195122
Finland,FIN,2,1,1,4,1928,Winter,41,0.097560976
Canada,CAN,1,0,0,1,1928,Winter,41,0.024390244
France,FRA,1,0,0,1,1928,Winter,41,0.024390244
Austria,AUT,0,3,1,4,1928,Winter,41,0.097560976
Belgium,BEL,0,0,1,1,1928,Winter,41,0.024390244
Czechoslovakia,TCH,0,0,1,1,1928,Winter,41,0.024390244
Germany,GER,0,0,1,1,1928,Winter,41,0.024390244
Great Britain,GBR,0,0,1,1,1928,Winter,41,0.024390244
Switzerland,SUI,0,0,1,1,1928,Winter,41,0.024390244
United States,USA,6,4,2,12,1932,Winter,42,0.285714286
Norway,NOR,3,4,3,10,1932,Winter,42,0.238095238
Sweden,SWE,1,2,0,3,1932,Winter,42,0.071428571
Canada,CAN,1,1,5,7,1932,Winter,42,0.166666667
Finland,FIN,1,1,1,3,1932,Winter,42,0.071428571
Austria,AUT,1,1,0,2,1932,Winter,42,0.047619048
France,FRA,1,0,0,1,1932,Winter,42,0.023809524
Switzerland,SUI,0,1,0,1,1932,Winter,42,0.023809524
Germany,GER,0,0,2,2,1932,Winter,42,0.047619048
Hungary,HUN,0,0,1,1,1932,Winter,42,0.023809524
Norway,NOR,7,5,3,15,1936,Winter,51,0.294117647
Germany,GER,3,3,0,6,1936,Winter,51,0.117647059
Sweden,SWE,2,2,3,7,1936,Winter,51,0.137254902
Finland,FIN,1,2,3,6,1936,Winter,51,0.117647059
Switzerland,SUI,1,2,0,3,1936,Winter,51,0.058823529
Austria,AUT,1,1,2,4,1936,Winter,51,0.078431373
Great Britain,GBR,1,1,1,3,1936,Winter,51,0.058823529
United States,USA,1,0,3,4,1936,Winter,51,0.078431373
Canada,CAN,0,1,0,1,1936,Winter,51,0.019607843
France,FRA,0,0,1,1,1936,Winter,51,0.019607843
Hungary,HUN,0,0,1,1,1936,Winter,51,0.019607843
Norway,NOR,4,3,3,10,1948,Winter,68,0.147058824
Sweden,SWE,4,3,3,10,1948,Winter,68,0.147058824
Switzerland,SUI,3,4,3,10,1948,Winter,68,0.147058824
United States,USA,3,4,2,9,1948,Winter,68,0.132352941
France,FRA,2,1,2,5,1948,Winter,68,0.073529412
Canada,CAN,2,0,1,3,1948,Winter,68,0.044117647
Austria,AUT,1,3,4,8,1948,Winter,68,0.117647059
Finland,FIN,1,3,2,6,1948,Winter,68,0.088235294
Belgium,BEL,1,1,0,2,1948,Winter,68,0.029411765
Italy,ITA,1,0,0,1,1948,Winter,68,0.014705882
Czechoslovakia,TCH,0,1,0,1,1948,Winter,68,0.014705882
Hungary,HUN,0,1,0,1,1948,Winter,68,0.014705882
Great Britain,GBR,0,0,2,2,1948,Winter,68,0.029411765
Norway,NOR,7,3,6,16,1952,Winter,67,0.23880597
United States,USA,4,6,1,11,1952,Winter,67,0.164179104
Finland,FIN,3,4,2,9,1952,Winter,67,0.134328358
Germany,GER,3,2,2,7,1952,Winter,67,0.104477612
Austria,AUT,2,4,2,8,1952,Winter,67,0.119402985
Canada,CAN,1,0,1,2,1952,Winter,67,0.029850746
Italy,ITA,1,0,1,2,1952,Winter,67,0.029850746
Great Britain,GBR,1,0,0,1,1952,Winter,67,0.014925373
Netherlands,NED,0,3,0,3,1952,Winter,67,0.044776119
Sweden,SWE,0,0,4,4,1952,Winter,67,0.059701493
Switzerland,SUI,0,0,2,2,1952,Winter,67,0.029850746
France,FRA,0,0,1,1,1952,Winter,67,0.014925373
Hungary,HUN,0,0,1,1,1952,Winter,67,0.014925373
Soviet Union,URS,7,3,6,16,1956,Winter,72,0.222222222
Austria,AUT,4,3,4,11,1956,Winter,72,0.152777778
Finland,FIN,3,3,1,7,1956,Winter,72,0.097222222
Switzerland,SUI,3,2,1,6,1956,Winter,72,0.083333333
Sweden,SWE,2,4,4,10,1956,Winter,72,0.138888889
United States,USA,2,3,2,7,1956,Winter,72,0.097222222
Norway,NOR,2,1,1,4,1956,Winter,72,0.055555556
Italy,ITA,1,2,0,3,1956,Winter,72,0.041666667
Germany,GER,1,0,1,2,1956,Winter,72,0.027777778
Canada,CAN,0,1,2,3,1956,Winter,72,0.041666667
Japan,JPN,0,1,0,1,1956,Winter,72,0.013888889
Hungary,HUN,0,0,1,1,1956,Winter,72,0.013888889
Poland,POL,0,0,1,1,1956,Winter,72,0.013888889
Soviet Union,URS,7,5,9,21,1960,Winter,81,0.259259259
Germany,GER,4,3,1,8,1960,Winter,81,0.098765432
United States,USA,3,4,3,10,1960,Winter,81,0.12345679
Norway,NOR,3,3,0,6,1960,Winter,81,0.074074074
Sweden,SWE,3,2,2,7,1960,Winter,81,0.086419753
Finland,FIN,2,3,3,8,1960,Winter,81,0.098765432
Canada,CAN,2,1,1,4,1960,Winter,81,0.049382716
Switzerland,SUI,2,0,0,2,1960,Winter,81,0.024691358
Austria,AUT,1,2,3,6,1960,Winter,81,0.074074074
France,FRA,1,0,2,3,1960,Winter,81,0.037037037
Netherlands,NED,0,1,1,2,1960,Winter,81,0.024691358
Poland,POL,0,1,1,2,1960,Winter,81,0.024691358
Czechoslovakia,TCH,0,1,0,1,1960,Winter,81,0.012345679
Italy,ITA,0,0,1,1,1960,Winter,81,0.012345679
Soviet Union,URS,11,8,6,25,1964,Winter,104,0.240384615
Austria,AUT,4,5,3,12,1964,Winter,104,0.115384615
Norway,NOR,3,6,6,15,1964,Winter,104,0.144230769
Finland,FIN,3,4,3,10,1964,Winter,104,0.096153846
France,FRA,3,4,0,7,1964,Winter,104,0.067307692
Germany,GER,3,3,3,9,1964,Winter,104,0.086538462
Sweden,SWE,3,3,1,7,1964,Winter,104,0.067307692
United States,USA,1,2,4,7,1964,Winter,104,0.067307692
Canada,CAN,1,1,1,3,1964,Winter,104,0.028846154
Netherlands,NED,1,1,0,2,1964,Winter,104,0.019230769
Great Britain,GBR,1,0,0,1,1964,Winter,104,0.009615385
Italy,ITA,0,1,3,4,1964,Winter,104,0.038461538
Democratic People's Republic of Korea,PRK,0,1,0,1,1964,Winter,104,0.009615385
Czechoslovakia,TCH,0,0,1,1,1964,Winter,104,0.009615385
Norway,NOR,6,6,2,14,1968,Winter,106,0.132075472
Soviet Union,URS,5,5,3,13,1968,Winter,106,0.122641509
France,FRA,4,3,2,9,1968,Winter,106,0.08490566
Italy,ITA,4,0,0,4,1968,Winter,106,0.037735849
Austria,AUT,3,4,4,11,1968,Winter,106,0.103773585
Netherlands,NED,3,3,3,9,1968,Winter,106,0.08490566
Sweden,SWE,3,2,3,8,1968,Winter,106,0.075471698
West Germany,FRG,2,2,3,7,1968,Winter,106,0.066037736
United States,USA,1,5,1,7,1968,Winter,106,0.066037736
East Germany,GDR,1,2,2,5,1968,Winter,106,0.047169811
Finland,FIN,1,2,2,5,1968,Winter,106,0.047169811
Czechoslovakia,TCH,1,2,1,4,1968,Winter,106,0.037735849
Canada,CAN,1,1,1,3,1968,Winter,106,0.028301887
Switzerland,SUI,0,2,4,6,1968,Winter,106,0.056603774
Romania,ROU,0,0,1,1,1968,Winter,106,0.009433962
Soviet Union,URS,8,5,3,16,1972,Winter,105,0.152380952
East Germany,GDR,4,3,7,14,1972,Winter,105,0.133333333
Switzerland,SUI,4,3,3,10,1972,Winter,105,0.095238095
Netherlands,NED,4,3,2,9,1972,Winter,105,0.085714286
United States,USA,3,2,3,8,1972,Winter,105,0.076190476
West Germany,FRG,3,1,1,5,1972,Winter,105,0.047619048
Norway,NOR,2,5,5,12,1972,Winter,105,0.114285714
Italy,ITA,2,2,1,5,1972,Winter,105,0.047619048
Austria,AUT,1,2,2,5,1972,Winter,105,0.047619048
Sweden,SWE,1,1,2,4,1972,Winter,105,0.038095238
Japan,JPN,1,1,1,3,1972,Winter,105,0.028571429
Czechoslovakia,TCH,1,0,2,3,1972,Winter,105,0.028571429
Poland,POL,1,0,0,1,1972,Winter,105,0.00952381
Spain,ESP,1,0,0,1,1972,Winter,105,0.00952381
Finland,FIN,0,4,1,5,1972,Winter,105,0.047619048
France,FRA,0,1,2,3,1972,Winter,105,0.028571429
Canada,CAN,0,1,0,1,1972,Winter,105,0.00952381
Soviet Union,URS,13,6,8,27,1976,Winter,111,0.243243243
East Germany,GDR,7,5,7,19,1976,Winter,111,0.171171171
United States,USA,3,3,4,10,1976,Winter,111,0.09009009
Norway,NOR,3,3,1,7,1976,Winter,111,0.063063063
West Germany,FRG,2,5,3,10,1976,Winter,111,0.09009009
Finland,FIN,2,4,1,7,1976,Winter,111,0.063063063
Austria,AUT,2,2,2,6,1976,Winter,111,0.054054054
Switzerland,SUI,1,3,1,5,1976,Winter,111,0.045045045
Netherlands,NED,1,2,3,6,1976,Winter,111,0.054054054
Italy,ITA,1,2,1,4,1976,Winter,111,0.036036036
Canada,CAN,1,1,1,3,1976,Winter,111,0.027027027
Great Britain,GBR,1,0,0,1,1976,Winter,111,0.009009009
Czechoslovakia,TCH,0,1,0,1,1976,Winter,111,0.009009009
Liechtenstein,LIE,0,0,2,2,1976,Winter,111,0.018018018
Sweden,SWE,0,0,2,2,1976,Winter,111,0.018018018
France,FRA,0,0,1,1,1976,Winter,111,0.009009009
Soviet Union,URS,10,6,6,22,1980,Winter,115,0.191304348
East Germany,GDR,9,7,7,23,1980,Winter,115,0.2
United States,USA,6,4,2,12,1980,Winter,115,0.104347826
Austria,AUT,3,2,2,7,1980,Winter,115,0.060869565
Sweden,SWE,3,0,1,4,1980,Winter,115,0.034782609
Liechtenstein,LIE,2,2,0,4,1980,Winter,115,0.034782609
Finland,FIN,1,5,3,9,1980,Winter,115,0.07826087
Norway,NOR,1,3,6,10,1980,Winter,115,0.086956522
Netherlands,NED,1,2,1,4,1980,Winter,115,0.034782609
Switzerland,SUI,1,1,3,5,1980,Winter,115,0.043478261
Great Britain,GBR,1,0,0,1,1980,Winter,115,0.008695652
West Germany,FRG,0,2,3,5,1980,Winter,115,0.043478261
Italy,ITA,0,2,0,2,1980,Winter,115,0.017391304
Canada,CAN,0,1,1,2,1980,Winter,115,0.017391304
Hungary,HUN,0,1,0,1,1980,Winter,115,0.008695652
Japan,JPN,0,1,0,1,1980,Winter,115,0.008695652
Bulgaria,BUL,0,0,1,1,1980,Winter,115,0.008695652
Czechoslovakia,TCH,0,0,1,1,1980,Winter,115,0.008695652
France,FRA,0,0,1,1,1980,Winter,115,0.008695652
East Germany,GDR,9,9,6,24,1984,Winter,117,0.205128205
Soviet Union,URS,6,10,9,25,1984,Winter,117,0.213675214
United States,USA,4,4,0,8,1984,Winter,117,0.068376068
Finland,FIN,4,3,6,13,1984,Winter,117,0.111111111
Sweden,SWE,4,2,2,8,1984,Winter,117,0.068376068
Norway,NOR,3,2,4,9,1984,Winter,117,0.076923077
Switzerland,SUI,2,2,1,5,1984,Winter,117,0.042735043
Canada,CAN,2,1,1,4,1984,Winter,117,0.034188034
West Germany,FRG,2,1,1,4,1984,Winter,117,0.034188034
Italy,ITA,2,0,0,2,1984,Winter,117,0.017094017
Great Britain,GBR,1,0,0,1,1984,Winter,117,0.008547009
Czechoslovakia,TCH,0,2,4,6,1984,Winter,117,0.051282051
France,FRA,0,1,2,3,1984,Winter,117,0.025641026
Japan,JPN,0,1,0,1,1984,Winter,117,0.008547009
Yugoslavia,YUG,0,1,0,1,1984,Winter,117,0.008547009
Liechtenstein,LIE,0,0,2,2,1984,Winter,117,0.017094017
Austria,AUT,0,0,1,1,1984,Winter,117,0.008547009
Soviet Union,URS,11,9,9,29,1988,Winter,138,0.210144928
East Germany,GDR,9,10,6,25,1988,Winter,138,0.18115942
Switzerland,SUI,5,5,5,15,1988,Winter,138,0.108695652
Finland,FIN,4,1,2,7,1988,Winter,138,0.050724638
Sweden,SWE,4,0,2,6,1988,Winter,138,0.043478261
Austria,AUT,3,5,2,10,1988,Winter,138,0.072463768
Netherlands,NED,3,2,2,7,1988,Winter,138,0.050724638
West Germany,FRG,2,4,2,8,1988,Winter,138,0.057971014
United States,USA,2,1,3,6,1988,Winter,138,0.043478261
Italy,ITA,2,1,2,5,1988,Winter,138,0.036231884
France,FRA,1,0,1,2,1988,Winter,138,0.014492754
Norway,NOR,0,3,2,5,1988,Winter,138,0.036231884
Canada,CAN,0,2,3,5,1988,Winter,138,0.036231884
Yugoslavia,YUG,0,2,1,3,1988,Winter,138,0.02173913
Czechoslovakia,TCH,0,1,2,3,1988,Winter,138,0.02173913
Japan,JPN,0,0,1,1,1988,Winter,138,0.007246377
Liechtenstein,LIE,0,0,1,1,1988,Winter,138,0.007246377
Germany,GER,10,10,6,26,1992,Winter,171,0.152046784
Unified Team,EUN,9,6,8,23,1992,Winter,171,0.134502924
Norway,NOR,9,6,5,20,1992,Winter,171,0.116959064
Austria,AUT,6,7,8,21,1992,Winter,171,0.122807018
United States,USA,5,4,2,11,1992,Winter,171,0.064327485
Italy,ITA,4,6,4,14,1992,Winter,171,0.081871345
France,FRA,3,5,1,9,1992,Winter,171,0.052631579
Finland,FIN,3,1,3,7,1992,Winter,171,0.040935673
Canada,CAN,2,3,2,7,1992,Winter,171,0.040935673
Republic of Korea,KOR,2,1,1,4,1992,Winter,171,0.023391813
Japan,JPN,1,2,4,7,1992,Winter,171,0.040935673
Netherlands,NED,1,1,2,4,1992,Winter,171,0.023391813
Sweden,SWE,1,0,3,4,1992,Winter,171,0.023391813
Switzerland,SUI,1,0,2,3,1992,Winter,171,0.01754386
People's Republic of China,CHN,0,3,0,3,1992,Winter,171,0.01754386
Luxembourg,LUX,0,2,0,2,1992,Winter,171,0.011695906
New Zealand,NZL,0,1,0,1,1992,Winter,171,0.005847953
Czechoslovakia,TCH,0,0,3,3,1992,Winter,171,0.01754386
Democratic People's Republic of Korea,PRK,0,0,1,1,1992,Winter,171,0.005847953
Spain,ESP,0,0,1,1,1992,Winter,171,0.005847953
Russian Federation,RUS,11,8,4,23,1994,Winter,183,0.12568306
Norway,NOR,10,11,5,26,1994,Winter,183,0.142076503
Germany,GER,9,7,8,24,1994,Winter,183,0.131147541
Italy,ITA,7,5,8,20,1994,Winter,183,0.109289617
United States,USA,6,5,2,13,1994,Winter,183,0.071038251
Republic of Korea,KOR,4,1,1,6,1994,Winter,183,0.032786885
Canada,CAN,3,6,4,13,1994,Winter,183,0.071038251
Switzerland,SUI,3,4,2,9,1994,Winter,183,0.049180328
Austria,AUT,2,3,4,9,1994,Winter,183,0.049180328
Sweden,SWE,2,1,0,3,1994,Winter,183,0.016393443
Japan,JPN,1,2,2,5,1994,Winter,183,0.027322404
Kazakhstan,KAZ,1,2,0,3,1994,Winter,183,0.016393443
Ukraine,UKR,1,0,1,2,1994,Winter,183,0.010928962
Uzbekistan,UZB,1,0,0,1,1994,Winter,183,0.005464481
Belarus,BLR,0,2,0,2,1994,Winter,183,0.010928962
Finland,FIN,0,1,5,6,1994,Winter,183,0.032786885
France,FRA,0,1,4,5,1994,Winter,183,0.027322404
Netherlands,NED,0,1,3,4,1994,Winter,183,0.021857923
People's Republic of China,CHN,0,1,2,3,1994,Winter,183,0.016393443
Slovenia,SLO,0,0,3,3,1994,Winter,183,0.016393443
Great Britain,GBR,0,0,2,2,1994,Winter,183,0.010928962
Australia,AUS,0,0,1,1,1994,Winter,183,0.005464481
Germany,GER,12,9,8,29,1998,Winter,205,0.141463415
Norway,NOR,10,10,5,25,1998,Winter,205,0.12195122
Russian Federation,RUS,9,6,3,18,1998,Winter,205,0.087804878
Canada,CAN,6,5,4,15,1998,Winter,205,0.073170732
United States,USA,6,3,4,13,1998,Winter,205,0.063414634
Netherlands,NED,5,4,2,11,1998,Winter,205,0.053658537
Japan,JPN,5,1,4,10,1998,Winter,205,0.048780488
Austria,AUT,3,5,9,17,1998,Winter,205,0.082926829
Republic of Korea,KOR,3,1,2,6,1998,Winter,205,0.029268293
Italy,ITA,2,6,2,10,1998,Winter,205,0.048780488
Finland,FIN,2,4,6,12,1998,Winter,205,0.058536585
Switzerland,SUI,2,2,3,7,1998,Winter,205,0.034146341
France,FRA,2,1,5,8,1998,Winter,205,0.03902439
Czechia,CZE,1,1,1,3,1998,Winter,205,0.014634146
Bulgaria,BUL,1,0,0,1,1998,Winter,205,0.004878049
People's Republic of China,CHN,0,6,2,8,1998,Winter,205,0.03902439
Sweden,SWE,0,2,1,3,1998,Winter,205,0.014634146
Denmark,DEN,0,1,0,1,1998,Winter,205,0.004878049
Ukraine,UKR,0,1,0,1,1998,Winter,205,0.004878049
Belarus,BLR,0,0,2,2,1998,Winter,205,0.009756098
Kazakhstan,KAZ,0,0,2,2,1998,Winter,205,0.009756098
Australia,AUS,0,0,1,1,1998,Winter,205,0.004878049
Belgium,BEL,0,0,1,1,1998,Winter,205,0.004878049
Great Britain,GBR,0,0,1,1,1998,Winter,205,0.004878049
Norway,NOR,13,5,7,25,2002,Winter,234,0.106837607
Germany,GER,12,16,8,36,2002,Winter,234,0.153846154
United States,USA,10,13,11,34,2002,Winter,234,0.145299145
Canada,CAN,7,3,7,17,2002,Winter,234,0.072649573
Russian Federation,RUS,5,4,4,13,2002,Winter,234,0.055555556
France,FRA,4,5,2,11,2002,Winter,234,0.047008547
Italy,ITA,4,4,5,13,2002,Winter,234,0.055555556
Finland,FIN,4,2,1,7,2002,Winter,234,0.02991453
Netherlands,NED,3,5,0,8,2002,Winter,234,0.034188034
Austria,AUT,3,4,10,17,2002,Winter,234,0.072649573
Switzerland,SUI,3,2,6,11,2002,Winter,234,0.047008547
Croatia,CRO,3,1,0,4,2002,Winter,234,0.017094017
People's Republic of China,CHN,2,2,4,8,2002,Winter,234,0.034188034
Republic of Korea,KOR,2,2,0,4,2002,Winter,234,0.017094017
Australia,AUS,2,0,0,2,2002,Winter,234,0.008547009
Czechia,CZE,1,2,0,3,2002,Winter,234,0.012820513
Estonia,EST,1,1,1,3,2002,Winter,234,0.012820513
Great Britain,GBR,1,0,1,2,2002,Winter,234,0.008547009
Sweden,SWE,0,2,5,7,2002,Winter,234,0.02991453
Bulgaria,BUL,0,1,2,3,2002,Winter,234,0.012820513
Japan,JPN,0,1,1,2,2002,Winter,234,0.008547009
Poland,POL,0,1,1,2,2002,Winter,234,0.008547009
Belarus,BLR,0,0,1,1,2002,Winter,234,0.004273504
Slovenia,SLO,0,0,1,1,2002,Winter,234,0.004273504
Germany,GER,11,12,6,29,2006,Winter,252,0.115079365
United States,USA,9,9,7,25,2006,Winter,252,0.099206349
Austria,AUT,9,7,7,23,2006,Winter,252,0.091269841
Russian Federation,RUS,8,6,8,22,2006,Winter,252,0.087301587
Canada,CAN,7,10,7,24,2006,Winter,252,0.095238095
Sweden,SWE,7,2,5,14,2006,Winter,252,0.055555556
Republic of Korea,KOR,6,3,2,11,2006,Winter,252,0.043650794
Switzerland,SUI,5,4,5,14,2006,Winter,252,0.055555556
Italy,ITA,5,0,6,11,2006,Winter,252,0.043650794
France,FRA,3,2,4,9,2006,Winter,252,0.035714286
Netherlands,NED,3,2,4,9,2006,Winter,252,0.035714286
Estonia,EST,3,0,0,3,2006,Winter,252,0.011904762
Norway,NOR,2,8,9,19,2006,Winter,252,0.075396825
People's Republic of China,CHN,2,4,5,11,2006,Winter,252,0.043650794
Czechia,CZE,1,2,1,4,2006,Winter,252,0.015873016
Croatia,CRO,1,2,0,3,2006,Winter,252,0.011904762
Australia,AUS,1,0,1,2,2006,Winter,252,0.007936508
Japan,JPN,1,0,0,1,2006,Winter,252,0.003968254
Finland,FIN,0,6,3,9,2006,Winter,252,0.035714286
Poland,POL,0,1,1,2,2006,Winter,252,0.007936508
Belarus,BLR,0,1,0,1,2006,Winter,252,0.003968254
Bulgaria,BUL,0,1,0,1,2006,Winter,252,0.003968254
Great Britain,GBR,0,1,0,1,2006,Winter,252,0.003968254
Slovakia,SVK,0,1,0,1,2006,Winter,252,0.003968254
Ukraine,UKR,0,0,2,2,2006,Winter,252,0.007936508
Latvia,LAT,0,0,1,1,2006,Winter,252,0.003968254
Canada,CAN,14,7,5,26,2010,Winter,258,0.100775194
Germany,GER,10,13,7,30,2010,Winter,258,0.11627907
United States,USA,9,15,13,37,2010,Winter,258,0.143410853
Norway,NOR,9,8,6,23,2010,Winter,258,0.089147287
Republic of Korea,KOR,6,6,2,14,2010,Winter,258,0.054263566
Switzerland,SUI,6,0,3,9,2010,Winter,258,0.034883721
People's Republic of China,CHN,5,2,4,11,2010,Winter,258,0.042635659
Sweden,SWE,5,2,4,11,2010,Winter,258,0.042635659
Austria,AUT,4,6,6,16,2010,Winter,258,0.062015504
Netherlands,NED,4,1,3,8,2010,Winter,258,0.031007752
Russian Federation,RUS,3,5,7,15,2010,Winter,258,0.058139535
France,FRA,2,3,6,11,2010,Winter,258,0.042635659
Australia,AUS,2,1,0,3,2010,Winter,258,0.011627907
Czechia,CZE,2,0,4,6,2010,Winter,258,0.023255814
Poland,POL,1,3,2,6,2010,Winter,258,0.023255814
Italy,ITA,1,1,3,5,2010,Winter,258,0.019379845
Belarus,BLR,1,1,1,3,2010,Winter,258,0.011627907
Slovakia,SVK,1,1,1,3,2010,Winter,258,0.011627907
Great Britain,GBR,1,0,0,1,2010,Winter,258,0.003875969
Japan,JPN,0,3,2,5,2010,Winter,258,0.019379845
Croatia,CRO,0,2,1,3,2010,Winter,258,0.011627907
Slovenia,SLO,0,2,1,3,2010,Winter,258,0.011627907
Latvia,LAT,0,2,0,2,2010,Winter,258,0.007751938
Finland,FIN,0,1,4,5,2010,Winter,258,0.019379845
Estonia,EST,0,1,0,1,2010,Winter,258,0.003875969
Kazakhstan,KAZ,0,1,0,1,2010,Winter,258,0.003875969
Norway,NOR,11,6,9,26,2014,Winter,294,0.088435374
Russian Federation,RUS,10,10,9,29,2014,Winter,294,0.098639456
Canada,CAN,10,10,5,25,2014,Winter,294,0.085034014
United States,USA,9,9,10,28,2014,Winter,294,0.095238095
Netherlands,NED,8,7,9,24,2014,Winter,294,0.081632653
Germany,GER,8,6,5,19,2014,Winter,294,0.06462585
Switzerland,SUI,7,2,2,11,2014,Winter,294,0.037414966
Belarus,BLR,5,0,1,6,2014,Winter,294,0.020408163
Austria,AUT,4,8,5,17,2014,Winter,294,0.057823129
France,FRA,4,4,7,15,2014,Winter,294,0.051020408
Poland,POL,4,1,1,6,2014,Winter,294,0.020408163
People's Republic of China,CHN,3,4,2,9,2014,Winter,294,0.030612245
Republic of Korea,KOR,3,3,2,8,2014,Winter,294,0.027210884
Sweden,SWE,2,7,6,15,2014,Winter,294,0.051020408
Czechia,CZE,2,4,3,9,2014,Winter,294,0.030612245
Slovenia,SLO,2,2,4,8,2014,Winter,294,0.027210884
Japan,JPN,1,4,3,8,2014,Winter,294,0.027210884
Finland,FIN,1,3,1,5,2014,Winter,294,0.017006803
Great Britain,GBR,1,1,3,5,2014,Winter,294,0.017006803
Latvia,LAT,1,1,3,5,2014,Winter,294,0.017006803
Ukraine,UKR,1,0,1,2,2014,Winter,294,0.006802721
Slovakia,SVK,1,0,0,1,2014,Winter,294,0.003401361
Italy,ITA,0,2,6,8,2014,Winter,294,0.027210884
Australia,AUS,0,2,1,3,2014,Winter,294,0.010204082
Croatia,CRO,0,1,0,1,2014,Winter,294,0.003401361
Kazakhstan,KAZ,0,0,1,1,2014,Winter,294,0.003401361
Norway,NOR,14,14,11,39,2018,Winter,307,0.127035831
Germany,GER,14,10,7,31,2018,Winter,307,0.100977199
Canada,CAN,11,8,10,29,2018,Winter,307,0.094462541
United States,USA,9,8,6,23,2018,Winter,307,0.074918567
Netherlands,NED,8,6,6,20,2018,Winter,307,0.06514658
Sweden,SWE,7,6,1,14,2018,Winter,307,0.045602606
Republic of Korea,KOR,5,8,4,17,2018,Winter,307,0.055374593
Switzerland,SUI,5,6,4,15,2018,Winter,307,0.048859935
France,FRA,5,4,6,15,2018,Winter,307,0.048859935
Austria,AUT,5,3,6,14,2018,Winter,307,0.045602606
Japan,JPN,4,5,4,13,2018,Winter,307,0.042345277
Italy,ITA,3,2,5,10,2018,Winter,307,0.03257329
ROC,ROC,2,6,9,17,2018,Winter,307,0.055374593
Czechia,CZE,2,2,3,7,2018,Winter,307,0.022801303
Belarus,BLR,2,1,0,3,2018,Winter,307,0.009771987
People's Republic of China,CHN,1,6,2,9,2018,Winter,307,0.029315961
Slovakia,SVK,1,2,0,3,2018,Winter,307,0.009771987
Finland,FIN,1,1,4,6,2018,Winter,307,0.019543974
Great Britain,GBR,1,0,4,5,2018,Winter,307,0.016286645
Poland,POL,1,0,1,2,2018,Winter,307,0.006514658
Hungary,HUN,1,0,0,1,2018,Winter,307,0.003257329
Ukraine,UKR,1,0,0,1,2018,Winter,307,0.003257329
Australia,AUS,0,2,1,3,2018,Winter,307,0.009771987
Slovenia,SLO,0,1,1,2,2018,Winter,307,0.006514658
Belgium,BEL,0,1,0,1,2018,Winter,307,0.003257329
New Zealand,NZL,0,0,2,2,2018,Winter,307,0.006514658
Spain,ESP,0,0,2,2,2018,Winter,307,0.006514658
Kazakhstan,KAZ,0,0,1,1,2018,Winter,307,0.003257329
Latvia,LAT,0,0,1,1,2018,Winter,307,0.003257329
Liechtenstein,LIE,0,0,1,1,2018,Winter,307,0.003257329
Norway,NOR,16,8,13,37,2022,Winter,328,0.112804878
Germany,GER,12,10,5,27,2022,Winter,328,0.082317073
People's Republic of China,CHN,9,4,2,15,2022,Winter,328,0.045731707
United States,USA,8,10,7,25,2022,Winter,328,0.076219512
Sweden,SWE,8,5,5,18,2022,Winter,328,0.054878049
Netherlands,NED,8,5,4,17,2022,Winter,328,0.051829268
Austria,AUT,7,7,4,18,2022,Winter,328,0.054878049
Switzerland,SUI,7,2,6,15,2022,Winter,328,0.045731707
ROC,ROC,6,12,14,32,2022,Winter,328,0.097560976
France,FRA,5,7,2,14,2022,Winter,328,0.042682927
Canada,CAN,4,8,14,26,2022,Winter,328,0.079268293
Japan,JPN,3,6,9,18,2022,Winter,328,0.054878049
Italy,ITA,2,7,8,17,2022,Winter,328,0.051829268
Republic of Korea,KOR,2,5,2,9,2022,Winter,328,0.027439024
Slovenia,SLO,2,3,2,7,2022,Winter,328,0.021341463
Finland,FIN,2,2,4,8,2022,Winter,328,0.024390244
New Zealand,NZL,2,1,0,3,2022,Winter,328,0.009146341
Australia,AUS,1,2,1,4,2022,Winter,328,0.012195122
Great Britain,GBR,1,1,0,2,2022,Winter,328,0.006097561
Hungary,HUN,1,0,2,3,2022,Winter,328,0.009146341
Belgium,BEL,1,0,1,2,2022,Winter,328,0.006097561
Czechia,CZE,1,0,1,2,2022,Winter,328,0.006097561
Slovakia,SVK,1,0,1,2,2022,Winter,328,0.006097561
Belarus,BLR,0,2,0,2,2022,Winter,328,0.006097561
Spain,ESP,0,1,0,1,2022,Winter,328,0.00304878
Ukraine,UKR,0,1,0,1,2022,Winter,328,0.00304878
Estonia,EST,0,0,1,1,2022,Winter,328,0.00304878
Latvia,LAT,0,0,1,1,2022,Winter,328,0.00304878
Poland,POL,0,0,1,1,2022,Winter,328,0.00304878
